,Policy,Total Sentences,Total Words,Total Explicit,Total Implicit,Total Other,Total Actions,Total Data Objects,Total Purposes
0,10Duke,129,2795,0,2,127,129,42,129
1,1nce,201,4053,1,4,196,201,61,201
2,3DHubs,117,2302,0,6,111,117,41,117
3,3DSystems,149,3371,0,12,137,149,54,149
4,3Forge,34,827,0,4,30,34,14,34
5,3onedata,60,1045,0,4,56,60,22,60
6,3scaleRedHat,176,4445,0,18,158,176,64,176
7,3SenseTechnology,203,5285,0,11,192,203,91,203
8,4NGLimited,29,603,0,1,28,29,8,29
9,51HiTech,7,43,0,0,7,7,1,7
10,5X,61,1032,0,2,59,61,18,61
11,6WIND,47,732,0,0,47,47,9,47
12,75F,238,6199,0,3,235,238,77,238
13,99Cloud,65,1562,0,6,59,65,28,65
14,9Solutions,50,975,0,2,48,50,20,50
15,AbacoSystems,178,4223,0,5,173,178,64,178
16,Abiogenix,34,760,0,3,31,34,16,34
17,ABIVIN,46,760,0,2,44,46,15,46
18,Abracon,3,30,0,0,3,3,0,3
19,Absolute,235,5812,0,19,216,235,106,235
20,Accenture,149,3537,0,10,139,149,50,149
21,AccumineTechnologiesLtd,26,539,0,2,24,26,12,26
22,AccureInc,24,426,0,1,23,24,3,24
23,AcePillar,82,1552,0,3,79,82,25,82
24,AcnodesCorporation,50,964,0,1,49,50,16,50
25,Acromag,56,1128,0,6,50,56,19,56
26,AcrosserTechnology,27,825,0,0,27,27,16,27
27,AcSiPTechnologyCorp,7,57,0,0,7,7,0,7
28,Actemium,154,3218,0,10,144,154,70,154
29,Actility,43,866,0,5,38,43,22,43
30,AcuityBrands,107,2641,0,16,91,107,74,107
31,Acunote,49,1081,0,4,45,49,23,49
32,AdafruitIndustries,142,2941,0,10,132,142,46,142
33,AdaptiveWirelessSolutions,154,3901,0,6,148,154,56,154
34,ADATA,115,2552,1,9,105,115,49,115
35,Adbits,89,2116,0,3,86,89,33,89
36,AdhereTech,109,2361,0,7,102,109,32,109
37,ADIEngineeringInc,67,1284,0,0,67,67,16,67
38,ADLINK,28,507,0,0,28,28,7,28
39,ADRF,108,2118,0,5,103,108,44,108
40,adstecGmbH,212,5804,0,9,203,212,92,212
41,ADTRANInc,120,2644,0,7,113,120,35,120
42,AdvancedEnergy,92,2015,0,11,81,92,29,92
43,AdvantagTecnologiaLtda,161,3681,0,8,153,161,78,161
44,Advantech,421,9340,0,25,396,421,154,421
45,AdvantechBBSmartWorxAdvantech,58,1119,0,3,55,58,27,58
46,Advanticsys,37,940,0,3,34,37,16,37
47,AegisMobility,49,990,0,6,43,49,26,49
48,AegisSoftware,144,3950,0,4,140,144,75,144
49,AegisTechnology,144,3950,0,4,140,144,75,144
50,AerodyneGroup,93,1968,0,7,86,93,42,93
51,Aeroscout,7,99,0,0,7,7,4,7
52,AEviceHealth,51,1398,0,2,49,51,19,51
53,AEWIN,133,2375,0,4,129,133,44,133
54,AFourTechnologies,46,989,0,2,44,46,19,46
55,AgilePQ,43,822,0,1,42,43,17,43
56,Aginova,14,174,0,0,14,14,5,14
57,AgLeader,32,537,0,0,32,32,9,32
58,AHGInc,49,1134,0,4,45,49,20,49
59,Aicas,292,6726,6,7,279,292,106,292
60,AICMonitor,113,2569,0,4,109,113,40,113
61,AikaanLabs,35,748,0,0,35,35,13,35
62,Ailytic,33,640,0,0,33,33,10,33
63,Airbiquity,46,1014,0,4,42,46,20,46
64,Airly,47,1025,0,2,45,47,14,47
65,Airtel,58,1376,0,2,56,58,20,58
66,AIStorm,5,34,0,0,5,5,1,5
67,AitechRobotics,136,3433,1,11,124,136,60,136
68,AIVIDTechvision,18,237,0,0,18,18,4,18
69,AiwaDigital,32,741,0,4,28,32,16,32
70,AkenzaAG,57,1446,0,4,53,57,24,57
71,Akvelon,57,1298,0,3,54,57,18,57
72,AlascomServicesSrl,23,630,0,2,21,23,14,23
73,AlgoEngines,58,1420,0,4,54,58,27,58
74,AlibabaCloudAliyun,87,2390,0,7,80,87,40,87
75,AlibabaGroup,33,795,0,2,31,33,13,33
76,AlienTechnology,57,1238,0,3,54,57,27,57
77,AlinketElectronicTechnologyShanghaiCoLtd,11,210,0,0,11,11,2,11
78,ALLEGION,134,3345,0,8,126,134,49,134
79,AllegroMicroSystems,136,3052,0,4,132,136,50,136
80,Alloy,132,3318,0,16,116,132,56,132
81,AllThingsTalk,14,264,0,2,12,14,8,14
82,AlnickoDevelopment,173,3628,0,8,165,173,57,173
83,ALOALTO,117,2276,0,3,114,117,33,117
84,AlphaampOmegaSemiconductor,42,786,0,2,40,42,13,42
85,AlphaOriTechnologies,73,1681,0,4,69,73,31,73
86,AlphaWire,49,1027,0,3,46,49,20,49
87,Alpwise,44,752,0,2,42,44,15,44
88,Altair,164,3835,0,13,151,164,61,164
89,AltairEDEM,164,3835,0,13,151,164,61,164
90,ALTENCalsoftLabs,22,322,0,0,22,22,1,22
91,AltiumLimited,117,2947,0,10,107,117,38,117
92,AltiuxInnovations,13,231,0,0,13,13,5,13
93,AltizonSystems,68,1591,0,4,64,68,27,68
94,Altoros,24,460,0,3,21,24,9,24
95,AltranTechnologies,114,2488,0,1,113,114,30,114
96,AlysonTaylor,76,1403,0,3,73,76,24,76
97,AmazonWebServices,107,2143,1,1,105,107,31,107
98,AmbiqMicro,61,1199,0,1,60,61,24,61
99,Ambyint,29,728,0,1,28,29,11,29
100,AMPDTechnologies,69,1473,0,3,66,69,32,69
101,AmphenolAdvancedSensors,85,1952,0,12,73,85,36,85
102,AmphenolRF,89,1961,0,11,78,89,38,89
103,Ampla,64,1303,0,2,62,64,16,64
104,AmplifiedEngineering,7,109,0,0,7,7,1,7
105,Ampotech,40,977,0,5,35,40,17,40
106,amsAG,132,3357,0,5,127,132,61,132
107,Anagog,158,3402,0,23,135,158,61,158
108,Anaren,3,40,0,0,3,3,0,3
109,AndrewCole,28,425,0,0,28,28,6,28
110,Ankoglass,102,2089,0,8,94,102,41,102
111,Anova,170,4544,0,5,165,170,76,170
112,Anritsu,46,1048,0,2,44,46,20,46
113,Antmicro,12,148,0,0,12,12,3,12
114,Antsomi,14,109,0,0,14,14,1,14
115,Antwork,62,1697,0,2,60,62,25,62
116,ApexAutomationandRobotics,18,388,0,0,18,18,6,18
117,Apio,105,2209,0,0,105,105,35,105
118,Aplex,67,1455,1,2,64,67,24,67
119,Apostera,24,253,0,1,23,24,6,24
120,AppliedInformaticsSoftwareEngineeringGmbH,30,481,0,2,28,30,10,30
121,AppliedRisk,22,484,0,1,21,22,13,22
122,Apptimia,40,625,0,1,39,40,16,40
123,Apptricity,9,196,0,0,9,9,3,9
124,Aptiv,103,2273,0,5,98,103,35,103
125,Aptomar,4,103,0,0,4,4,1,4
126,APUQI,50,951,0,1,49,50,17,50
127,AquamatiXLtd,46,748,0,1,45,46,19,46
128,Aquicore,80,1777,0,10,70,80,32,80
129,Aranet,5,149,0,0,5,5,2,5
130,ArasCorp,19,278,0,2,17,19,10,19
131,ARAYA,14,251,0,2,12,14,4,14
132,ArborTechnology,52,967,1,8,43,52,23,52
133,ArcadiaDataCloudera,34,498,0,0,34,34,9,34
134,ARCHERMIND,60,1126,0,1,59,60,18,60
135,ARCSTONE,13,314,0,1,12,13,4,13
136,ARDIC,17,396,0,4,13,17,10,17
137,Arduino,207,6041,0,27,180,207,109,207
138,ArecontVision,55,1242,0,4,51,55,23,55
139,ArgusControlSystems,19,253,0,1,18,19,3,19
140,Argustechnologies,83,1761,0,4,79,83,23,83
141,AritaWebInc,35,597,0,1,34,35,10,35
142,Arkessa,135,2660,0,1,134,135,44,135
143,Arm,105,2473,0,10,95,105,36,105
144,ArmadaChain,27,771,0,5,22,27,15,27
145,ArmItCo,46,1008,0,1,45,46,18,46
146,Array,32,496,0,2,30,32,5,32
147,ArtesisAS,38,589,0,3,35,38,19,38
148,ArtesynEmbeddedTechnologies,107,2759,0,3,104,107,43,107
149,ArtiMindsRoboticsGmbH,20,282,0,0,20,20,7,20
150,ArubaNetworksHewlettPackardEnterpriseHPE,11,146,0,0,11,11,1,11
151,ArundoAnalytics,113,2873,0,5,108,113,44,113
152,Arviem,61,1125,0,2,59,61,25,61
153,ArxanTechnologies,95,1973,0,6,89,95,37,95
154,AsahiKaseiMicrodevices,92,1750,0,3,89,92,26,92
155,ASATTech,25,469,0,0,25,25,11,25
156,Asavie,106,2437,0,1,105,106,39,106
157,Ascalia,77,1416,0,1,76,77,32,77
158,AscomAG,86,1891,0,5,81,86,46,86
159,ASOCS,61,1088,0,2,59,61,20,61
160,Aspen,132,3156,0,4,128,132,50,132
161,AspireSystems,89,1755,0,5,84,89,34,89
162,AssetPulse,28,494,0,0,28,28,13,28
163,astozi,101,2118,0,8,93,101,45,101
164,Astralink,40,883,0,0,40,40,12,40
165,Astrata,28,598,0,1,27,28,14,28
166,AtachiSystems,66,1358,0,1,65,66,19,66
167,ATampT,136,2555,0,6,130,136,39,136
168,Atheer,130,2756,0,9,121,130,44,130
169,AtmarkTechno,0,0,0,0,0,0,0,0
170,Atollogy,70,1831,0,6,64,70,33,70
171,AtomRobot,82,1917,0,7,75,82,40,82
172,ATPElectronicsInc,81,1348,0,5,76,81,31,81
173,ATS,118,3041,0,5,113,118,38,118
174,ATTAbotics,51,900,0,1,50,51,12,51
175,Attify,44,967,0,2,42,44,13,44
176,ATTOTechnologyInc,45,744,0,4,41,45,16,45
177,Augmate,73,1456,0,5,68,73,34,73
178,Augmedix,13,212,0,0,13,13,2,13
179,Augment,102,1782,0,3,99,102,24,102
180,Augmenta,60,1086,0,1,59,60,23,60
181,AugmentasticPrivateLimited,143,3049,0,7,136,143,53,143
182,AugmentedPixels,27,621,0,1,26,27,9,27
183,AugmentedRadarImaging,21,252,0,1,20,21,7,21
184,Augmentus,0,0,0,0,0,0,0,0
185,AukIndustries,65,1871,0,6,59,65,34,65
186,AureliusEnterprise,116,2358,0,10,106,116,41,116
187,AuroSysSolutionsLLC,56,1326,0,6,50,56,23,56
188,AutomationAnywhere,106,2936,0,16,90,106,43,106
189,AutomatizacionCorp,37,1018,0,7,30,37,23,37
190,Automile,88,1758,0,7,81,88,30,88
191,Autonoma,41,686,0,1,40,41,15,41
192,Autotalks,114,2146,0,6,108,114,41,114
193,AutoTrip,36,638,0,0,36,36,14,36
194,AutoX,32,754,0,2,30,32,15,32
195,Auvesy,12,168,0,0,12,12,4,12
196,AvaLANWireless,9,159,0,0,9,9,4,9
197,AvalueTechnology,25,495,0,0,25,25,6,25
198,AvanadeAccenture,110,2757,0,6,104,110,35,110
199,AvanadeJapanKK,110,2757,0,6,104,110,35,110
200,Avanseus,42,725,0,0,42,42,13,42
201,AveryDennison,89,2056,0,7,82,89,35,89
202,AVEVASchneiderElectric,96,2151,0,4,92,96,29,96
203,AWcloud,31,488,0,0,31,31,6,31
204,AwenCollectiveLtd,44,976,2,2,40,44,15,44
205,AxilionSmartMobility,87,1714,0,7,80,87,31,87
206,Axiros,42,968,0,5,37,42,15,42
207,AxisCommunications,83,1921,0,5,78,83,31,83
208,Axonize,86,1771,0,6,80,86,24,86
209,AXOOM,166,3628,0,4,162,166,57,166
210,AXOOMTRUMPF,34,518,0,0,34,34,9,34
211,Axora,69,1303,0,0,69,69,21,69
212,Axper,16,369,0,2,14,16,4,16
213,AXULUSIndustrieReplyGmbH,190,3932,0,1,189,190,80,190
214,Ayyeka,60,1337,0,5,55,60,20,60
215,AzbilCorporation,25,482,0,2,23,25,9,25
216,azetiNetworksAG,89,1410,0,2,87,89,40,89
217,BadgeControl,20,481,0,2,18,20,11,20
218,BAESystems,15,240,0,0,15,15,3,15
219,Baidu,23,380,0,3,20,23,9,23
220,BaishanCloud,12,210,0,0,12,12,1,12
221,BakerHughes,97,2278,0,4,93,97,44,97
222,Balluff,25,464,0,0,25,25,11,25
223,BampKPrecisionCorporation,23,515,0,2,21,23,12,23
224,BampRIndustrialAutomationABB,114,3006,0,8,106,114,47,114
225,Bandweaver,28,458,0,1,27,28,7,28
226,BangDB,140,2875,0,6,134,140,43,140
227,BanyanWater,23,469,0,3,20,23,6,23
228,Baraja,21,522,0,0,21,21,11,21
229,BarbaraIoT,31,509,0,3,28,31,12,31
230,Barting,36,482,0,0,36,36,6,36
231,BaseN,36,664,0,2,34,36,14,36
232,BaslerAG,65,1078,0,1,64,65,18,65
233,BastilleNetworks,15,322,0,1,14,15,6,15
234,Baumer,186,2965,0,9,177,186,71,186
235,Baumller,245,6108,1,12,232,245,101,245
236,BayshoreNetworksInc,8,163,0,0,8,8,0,8
237,bcFoodERP,16,151,0,0,16,16,1,16
238,BDP,0,0,0,0,0,0,0,0
239,BDStar,56,982,0,0,56,56,19,56
240,BeagleBoardorg,42,618,0,1,41,42,14,42
241,BeBopSensors,23,319,0,0,23,23,5,23
242,Beckhoff,173,3686,0,12,161,173,52,173
243,BeijingExtechScienceampTechnologyCo,65,1173,0,3,62,65,20,65
244,Belden,113,2492,0,14,99,113,48,113
245,Belitsoft,75,1034,0,3,72,75,25,75
246,BenchmarkElectronics,39,844,0,4,35,39,13,39
247,Benewake,17,396,0,0,17,17,10,17
248,Bestmile,7,56,0,0,7,7,2,7
249,BevywiseNetworks,27,453,0,1,26,27,8,27
250,BICS,69,1617,0,4,65,69,19,69
251,BidukElectronic,33,598,0,3,30,33,15,33
252,BigBelly,123,2758,0,9,114,123,38,123
253,Bigtera,8,107,0,1,7,8,3,8
254,Binare,34,669,0,7,27,34,22,34
255,Bitfidence,181,4274,2,8,171,181,74,181
256,Bitscape,55,1044,0,2,53,55,22,55
257,Biz4Intellia,55,908,0,0,55,55,18,55
258,BlackBerry,150,3546,0,7,143,150,69,150
259,Blesh,13,442,0,2,11,13,8,13
260,Blippar,72,1650,0,6,66,72,39,72
261,BlonderTongueLaboratories,114,2015,0,1,113,114,26,114
262,BloxMove,48,740,0,1,47,48,12,48
263,BlueBotics,96,2118,0,3,93,96,26,96
264,Bluecity,305,8046,0,21,284,305,124,305
265,BlueDanubeRobotics,8,113,0,0,8,8,2,8
266,BlueIoT,50,899,0,5,45,50,21,50
267,BlueLink,111,2524,0,7,104,111,32,111
268,BlueMaestro,44,746,0,2,42,44,10,44
269,BluePillar,1,8,0,0,1,1,0,1
270,Bluewrist,9,159,0,1,8,9,4,9
271,BohuaTechnology,16,180,0,0,16,16,4,16
272,BooCax,22,409,0,1,21,22,5,22
273,Bosch,208,4433,0,20,188,208,74,208
274,BoschAutomotiveServiceBosch,14,337,0,2,12,14,3,14
275,BoschIoTSuiteBosch,63,1193,0,4,59,63,19,63
276,BoschSecuritySystemsBosch,132,2523,0,4,128,132,41,132
277,BoschTool,221,4822,0,22,199,221,87,221
278,BostonDynamics,71,1503,0,5,66,71,31,71
279,BradyCorporation,13,238,0,0,13,13,8,13
280,BridgeraLLC,150,4183,0,6,144,150,65,150
281,BrightWolf,22,358,0,1,21,22,4,22
282,Briq,309,6789,0,21,288,309,94,309
283,Bristlecone,29,482,0,2,27,29,7,29
284,BroadSignInternational,57,1131,0,2,55,57,20,57
285,BSCADA,5,69,0,0,5,5,0,5
286,BSI,63,1769,0,2,61,63,17,63
287,Bsquare,86,1822,0,2,84,86,29,86
288,BugLabs,27,514,0,1,26,27,6,27
289,BuilderX,85,1558,0,4,81,85,24,85
290,BuildingMinds,145,2720,0,6,139,145,54,145
291,BuildSim,101,1504,0,3,98,101,28,101
292,BuiltRobotics,64,1441,1,4,59,64,20,64
293,BulldozAIR,34,583,0,4,30,34,15,34
294,BullGuard,14,281,0,0,14,14,0,14
295,BURNDYLLC,11,228,0,0,11,11,3,11
296,BuzzSolutions,116,2038,0,7,109,116,39,116
297,C2RO,4,117,0,0,4,4,2,4
298,C2Sense,28,622,0,1,27,28,13,28
299,C3IoT,78,1626,0,9,69,78,28,78
300,CadBlu,8,306,0,2,6,8,5,8
301,CaimoreTechnology,96,2254,0,10,86,96,47,96
302,CalAmp,128,2852,0,7,121,128,45,128
303,CalibreEngineering,41,894,0,5,36,41,20,41
304,CaliforniaEasternLaboratoriesCEL,45,1018,0,4,41,45,15,45
305,Camio,86,1820,0,8,78,86,36,86
306,CanaanCreative,40,583,0,2,38,40,11,40
307,CanonicalGroup,150,2738,1,7,142,150,45,150
308,CanonInc,91,2117,0,8,83,91,38,91
309,Cantechs,31,598,0,5,26,31,16,31
310,CanvassAnalytics,17,372,0,2,15,17,7,17
311,CapitalNumbersInfotechPvtLtd,189,3986,0,8,181,189,60,189
312,Capitoline,30,621,0,3,27,30,11,30
313,CapsuleTechQualcomm,22,431,0,0,22,22,8,22
314,Carbon3D,142,3668,0,9,133,142,58,142
315,CardyIntelligentTechnology,28,395,0,0,28,28,10,28
316,CargoSense,74,1804,0,2,72,74,25,74
317,CarnegieTechnologies,29,476,0,2,27,29,8,29
318,Cartesiamai,125,2977,0,6,119,125,36,125
319,CASIcloud,15,177,0,0,15,15,3,15
320,CASPEL,44,742,0,2,42,44,15,44
321,CavliWireless,54,1046,0,9,45,54,24,54
322,CaxaTechnology,79,1621,0,9,70,79,42,79
323,Celeno,75,1607,0,2,73,75,25,75
324,Celona,63,1162,0,3,60,63,15,63
325,CENTRITechnology,109,2301,0,7,102,109,39,109
326,CenturyLink,79,1719,0,2,77,79,21,79
327,CermetekMicroelectronics,9,171,0,4,5,9,5,9
328,CerraSystems,17,311,0,1,16,17,6,17
329,Certusnet,85,1651,0,4,81,85,24,85
330,Cetec,60,1082,0,2,58,60,19,60
331,CGI,14,191,0,0,14,14,3,14
332,ChargePoint,60,1226,0,5,55,60,19,60
333,ChatsworthProducts,65,1461,0,2,63,65,25,65
334,CheckPoint,89,2062,0,4,85,89,32,89
335,ChemspeedTechnologies,217,5758,0,9,208,217,103,217
336,ChengduEbyteElectronicTechnologyCoLtd,9,252,0,1,8,9,4,9
337,ChinaBavoraPrintedPackagingCoLtd,12,133,0,0,12,12,2,12
338,ChinaHiCloud,34,895,0,0,34,34,25,34
339,ChinaMobile,36,977,0,2,34,36,17,36
340,ChinaNetCenter,43,1427,0,2,41,43,34,43
341,ChinaProfoundTechnology,20,420,0,1,19,20,10,20
342,ChinaTelecom,163,3896,0,10,153,163,65,163
343,ChinaTelecomAmericas,163,3896,0,10,153,163,65,163
344,ChinaTransinfo,16,301,0,0,16,16,7,16
345,ChipkinAutomationSystems,84,1353,0,0,84,84,17,84
346,Chirp,117,2649,0,10,107,117,53,117
347,CIARATechnologies,224,6028,0,9,215,224,110,224
348,CIMON,9,100,0,0,9,9,1,9
349,CircuitCo,90,1692,0,6,84,90,28,90
350,Circulor,5,64,0,0,5,5,1,5
351,Cisco,127,2699,0,4,123,127,47,127
352,Citrix,151,3446,0,16,135,151,67,150
353,CityworksTrimble,6,53,0,0,6,6,0,6
354,Cityzenith,113,2335,0,5,108,113,35,113
355,CivicConnect,17,410,0,0,17,17,8,17
356,CivilMaps,18,391,0,0,18,18,8,18
357,CLabs,14,272,0,2,12,14,8,14
358,CLabsCorporationTRUMPF,10,147,0,0,10,10,4,10
359,ClariscoSolutions,34,592,0,2,32,34,15,34
360,ClariveSoftware,130,3221,1,11,118,130,58,130
361,Claroty,94,1923,0,7,87,94,31,94
362,ClearBlade,48,917,0,2,46,48,15,48
363,ClearMetal,36,542,0,0,36,36,13,36
364,ClearObject,102,2091,0,6,96,102,32,102
365,CleverCloud,55,1213,0,6,49,55,21,55
366,Cleveroad,92,1233,0,5,87,92,11,92
367,CLOPTechnologies,50,957,0,2,48,50,25,50
368,CloudBackend,27,445,0,0,27,27,6,27
369,Cloudera,210,4680,0,17,193,210,93,210
370,Cloudify,124,2188,0,6,118,124,32,124
371,CloudMile,36,650,0,1,35,36,11,36
372,CloudofThings,17,266,0,0,17,17,6,17
373,CloudRail,101,2285,0,6,95,101,35,101
374,CloudSigma,1,18,0,0,1,1,0,1
375,CloudStudio,88,1815,0,4,84,88,30,88
376,Cloudwalk,29,580,0,2,27,29,11,29
377,CloudWalkTechnology,29,678,0,5,24,29,12,29
378,CloverDynamics,254,3543,0,8,246,254,61,254
379,Coast2Coast,53,867,0,1,52,53,19,53
380,Cobot,136,2957,0,12,124,136,50,136
381,CobotNation,136,2957,0,12,124,136,50,136
382,CodeIT,43,976,0,6,37,43,19,43
383,Coderise,23,376,0,0,23,23,6,23
384,CodersDev,23,376,0,0,23,23,6,23
385,Codesys,154,2776,0,6,148,154,45,154
386,CodianRobotics,107,2231,0,4,103,107,47,107
387,CogitoInstrumentsSA,208,4205,0,16,192,208,62,208
388,COGNEX,92,1982,0,11,81,92,50,92
389,Cognigy,232,4351,0,11,221,232,64,232
390,Cognition,89,1996,0,5,84,89,23,89
391,Cognizant,91,2307,0,4,87,91,37,91
392,Comfy,93,2309,0,6,87,93,36,93
393,ComingTek,16,244,0,0,16,16,7,16
394,CommonlandsLLC,90,2244,0,3,87,90,31,90
395,CommScope,129,2767,0,4,125,129,34,129
396,Commsignia,126,3236,0,9,117,126,62,126
397,ComNet,72,1462,0,2,70,72,29,72
398,Comodule,86,1691,1,6,79,86,36,86
399,Compasses,138,3189,0,10,128,138,50,138
400,ComponentSoft,68,1266,0,3,65,68,28,68
401,Comsol,107,2571,0,7,100,107,38,107
402,ComtrolCorporation,28,571,0,3,25,28,10,28
403,ConcreteSensors,83,1538,0,6,77,83,32,83
404,Confidex,62,975,0,5,57,62,24,62
405,Confluent,169,4493,0,21,148,169,62,169
406,congatecAG,48,977,0,3,45,48,12,48
407,Connect2mePlasmaBusinessIntelligence,91,2241,0,9,82,91,43,91
408,Connectedthinks,68,1333,0,4,64,68,32,68
409,Connecthings,134,3384,0,5,129,134,64,134
410,ConnectM,163,3809,0,24,139,163,70,163
411,Connexxs,7,132,0,0,7,7,1,7
412,Connio,61,1289,0,16,45,61,34,61
413,ConperioTechnologySolutions,4,52,0,0,4,4,0,4
414,CONTACTSoftwareGmbH,122,2421,0,9,113,122,33,122
415,Contguard,69,1740,0,8,61,69,23,69
416,Contrinex,25,484,0,2,23,25,15,25
417,Converge,101,1942,0,6,95,101,25,101
418,Coolmay,1,5,0,0,1,1,0,1
419,COPADATA,200,3541,0,17,183,200,79,200
420,CordisSuite,60,1236,0,2,58,60,23,60
421,CorentTechnologyInc,76,1695,0,6,70,76,42,76
422,CoreRFID,90,1410,0,4,86,90,23,90
423,Corlina,87,2064,0,9,78,87,36,87
424,CorningOpticalCommunications,30,751,0,0,30,30,16,30
425,Couchbase,158,3514,0,12,146,158,53,158
426,CountBOX,40,968,0,4,36,40,18,40
427,covariant,52,1164,0,1,51,52,15,52
428,Covisint,41,1436,0,1,40,41,19,41
429,Cradlepoint,83,1448,0,2,81,83,19,83
430,Craftworks,51,1101,0,7,44,51,17,51
431,CrateDB,146,2814,0,8,138,146,52,146
432,Crateio,146,2814,0,8,138,146,52,146
433,Cree,248,5478,0,21,227,248,91,248
434,CrestronElectronics,50,857,0,4,46,50,18,50
435,CriticalBlue,188,3462,2,11,175,188,54,188
436,CriticalLinkLLC,27,541,0,4,23,27,12,27
437,CrodeonTechnologies,99,2067,0,5,94,99,27,99
438,CronJ,34,597,0,0,34,34,10,34
439,Crosscut,53,1152,0,7,46,53,27,53
440,CrosserTechnologies,73,1363,0,5,68,73,29,73
441,CrownDigital,23,509,0,0,23,23,5,23
442,CSBSystemAG,221,5481,0,5,216,221,96,221
443,CTrackInseego,47,896,0,6,41,47,23,47
444,CTSCorporation,17,247,0,2,15,17,5,17
445,Cubilog,5,36,0,0,5,5,0,5
446,CuelogicTechnologies,73,1499,0,4,69,73,23,73
447,CumulusNetworks,27,440,0,1,26,27,9,27
448,CurtissWrightDefenseSolutions,147,3315,0,12,135,147,60,147
449,Cybera,179,3958,0,15,164,179,60,179
450,CyberGRX,118,2869,0,13,105,118,41,118
451,Cyberinsight,111,2283,0,5,106,111,40,111
452,CyberVision,42,1072,0,1,41,42,13,42
453,Cybus,8,98,0,0,8,8,3,8
454,CYFIRMA,61,1291,0,6,55,61,22,61
455,CygnetInfotech,106,2441,0,6,100,106,36,106
456,CYIENT,44,808,0,3,41,44,13,44
457,CynLr,65,1211,0,0,65,65,27,65
458,CyPhySystems,94,2057,0,6,88,94,36,94
459,CypressSemiconductor,2,8,0,0,2,2,0,2
460,DaacoworksTechnologiesPrivateLimited,62,1200,0,1,61,62,16,62
461,Dacom,65,1133,0,0,65,65,12,65
462,DaintreeNetworksGECurrentGeneralElectric,28,318,0,0,28,28,5,28
463,Daizy,145,2661,0,5,140,145,39,145
464,DaliWorks,113,2703,0,7,106,113,49,113
465,DAQRI,146,2664,0,1,145,146,54,146
466,DarkTrace,255,5072,0,11,244,255,82,255
467,Dash,101,2372,0,5,96,101,35,101
468,Dashboard,31,509,0,2,29,31,10,31
469,Dashmote,73,1327,0,1,72,73,22,73
470,DassaultSystemes,124,2969,0,9,115,124,49,124
471,Datacor,92,2208,0,9,83,92,43,92
472,DataGekko,191,3243,0,10,181,191,73,191
473,DataHunter,99,1555,0,6,93,99,27,99
474,Dataiku,12,116,0,0,12,12,1,12
475,Datalogic,95,2536,0,4,91,95,43,95
476,DataMesh,93,1912,0,3,90,93,35,93
477,DATAMODUL,125,2247,0,5,120,125,45,125
478,DataRobot,166,3322,0,8,158,166,54,166
479,Datoms,66,1369,0,3,63,66,22,66
480,Datumize,53,1080,0,1,52,53,17,53
481,Dawex,49,934,0,3,46,49,21,49
482,dDrivenSolutions,109,2348,0,7,102,109,43,109
483,dDrivenSolutionsPteLtd,107,2620,0,3,104,107,35,107
484,Deacom,54,926,0,2,52,54,12,54
485,Deci,51,1088,0,4,47,51,26,51
486,Decisyon,36,618,0,1,35,36,9,36
487,DeepCube,40,946,0,2,38,40,24,40
488,DeepfieldRoboticsBosch,35,700,0,1,34,35,13,35
489,DeepInstinct,69,1480,0,8,61,69,26,69
490,DeepMind,41,854,0,3,38,41,14,41
491,DeepVision,90,2213,0,12,78,90,48,90
492,Delair,68,1240,0,2,66,68,32,68
493,Deliforce,62,1022,0,1,61,62,17,62
494,DellBoomiDellDellTechnologies,79,1313,0,1,78,79,18,79
495,DellTechnologies,59,885,0,3,56,59,10,59
496,DeloitteLLP,91,2160,0,6,85,91,35,91
497,Delphi,86,1624,0,7,79,86,37,86
498,Deltek,99,2145,0,7,92,99,43,99
499,Dematic,127,2728,0,4,123,127,49,127
500,Dennek,181,3648,0,10,171,181,73,181
501,Densify,52,826,0,2,50,52,10,51
502,DENSOCorporation,32,665,0,2,30,32,9,32
503,Derdack,57,982,0,3,54,57,14,57
504,DetectTechnologies,70,1549,0,9,61,70,23,70
505,DeutscheTelekom,25,287,0,0,25,25,4,25
506,DeviceHive,71,1415,0,3,68,71,23,71
507,DeviceLynk,17,242,0,0,17,17,6,17
508,DevicePilot,106,2245,0,4,102,106,40,106
509,DevicoSolutions,41,830,0,3,38,41,17,41
510,DeviQA,64,1227,0,6,58,64,23,64
511,DevTechnosys,45,756,0,2,43,45,17,45
512,DEVTecnologia,53,1057,0,3,50,53,16,53
513,DFI,96,1857,1,2,93,96,35,96
514,DGLogik,5,76,0,0,5,5,2,5
515,DGT,39,677,0,1,38,39,11,39
516,Digi,151,3174,0,12,139,151,49,151
517,DigiCert,90,2111,0,4,86,90,40,90
518,DigiLens,0,0,0,0,0,0,0,0
519,DIGIMONDO,56,860,0,0,56,56,32,56
520,DigiStar,25,522,0,1,24,25,14,25
521,DigitalAlloys,140,2672,0,8,132,140,41,140
522,DigitalBarriers,41,1021,0,5,36,41,16,41
523,DigitalChina,79,1714,0,9,70,79,44,79
524,DigitalDreamLabs,13,212,0,0,13,13,2,13
525,DigitalOcean,79,1709,0,3,76,79,28,79
526,DigitwinTechnologies,76,1454,0,3,73,76,27,76
527,DigiWin,18,349,0,2,16,18,6,18
528,Diodes,56,1187,0,6,50,56,25,56
529,DiodesIncorporated,56,1187,0,6,50,56,25,56
530,Diota,38,677,0,1,37,38,15,38
531,DirectInsight,70,1420,0,3,67,70,21,70
532,Distence,28,365,0,0,28,28,5,28
533,DistributedServicesArchitectureDSA,24,528,0,0,24,24,14,24
534,Dito,8,105,0,0,8,8,2,8
535,Dizmo,48,1094,0,10,38,48,23,48
536,DJIEnterprise,151,3278,0,7,144,151,55,151
537,Dobot,107,1860,0,11,96,107,34,107
538,Documoto,108,2214,0,6,102,108,32,108
539,DONNTechnology,13,245,0,1,12,13,4,13
540,Doorport,62,1042,0,0,62,62,20,62
541,DOrbit,25,477,0,2,23,25,13,25
542,DorsaVi,114,2677,0,2,112,114,37,114
543,DouglasLightingControlsPanasonic,11,147,0,0,11,11,2,11
544,DPTechnology,107,2323,0,2,105,107,33,107
545,DQAustralia,20,321,0,2,18,20,8,20
546,dragampbot,36,475,0,0,36,36,13,36
547,Draganfly,44,683,0,0,44,44,15,44
548,Drishti,49,1016,1,2,46,49,15,49
549,DroneBase,71,1592,0,4,67,71,30,71
550,DroneDeploy,132,3187,0,15,117,132,53,132
551,DroneLogbook,70,1980,0,2,68,70,30,70
552,dronephotographybournemouth,63,1182,0,3,60,63,19,63
553,DScifer,15,198,0,0,15,15,4,15
554,DTSLGroup,24,479,0,0,24,24,6,24
555,DUALiInc,47,1133,0,4,43,47,25,47
556,Durr,507,9982,2,18,487,507,170,507
557,Duwei,58,1026,0,4,54,58,21,58
558,DXCTechnology,114,3309,0,6,108,114,58,114
559,DynalogIndiaLtd,0,0,0,0,0,0,0,0
560,Dyocense,3,10,0,0,3,3,0,3
561,e2v,4,23,0,0,4,4,0,4
562,Eagle,73,1154,0,4,69,73,15,73
563,EagleIO,73,1154,0,4,69,73,15,73
564,EasyMile,44,960,1,2,41,44,26,44
565,Ebizneeds,135,2276,0,0,135,135,38,135
566,ECiSolutions,11,195,0,0,11,11,3,11
567,EclipseFoundation,33,602,0,1,32,33,9,33
568,EclipseIoT,33,602,0,1,32,33,9,33
569,econSystems,12,175,0,0,12,12,2,12
570,EcoPlant,27,619,0,1,26,27,10,27
571,Ecorithm,85,1837,0,3,82,85,39,85
572,Ecubelabs,58,1216,0,9,49,58,25,58
573,Edge2WebInc,84,1631,0,9,75,84,33,84
574,EdgeIQ,25,312,0,0,25,25,2,25
575,Edgematrix,14,278,0,0,14,14,6,14
576,Edgeworx,25,428,0,2,23,25,7,25
577,EDMI,33,818,0,1,32,33,12,33
578,Edyza,13,238,0,1,12,13,7,13
579,Efytechnology,37,591,0,0,37,37,14,37
580,EHANG,69,1932,0,6,63,69,38,69
581,ei3Corporation,196,4770,0,8,188,196,72,196
582,EICAS,42,976,0,1,41,42,10,42
583,Einride,28,647,0,1,27,28,10,28
584,EKEElectronics,7,131,0,1,6,7,2,7
585,elastic,23,243,0,0,23,23,7,23
586,ElecsysCorporation,120,2636,0,8,112,120,45,120
587,ElectricImpTwilio,349,7949,0,37,312,349,155,349
588,ElementAI,152,3239,0,12,140,152,43,152
589,ElementAnalytics,47,915,0,4,43,47,14,47
590,Elevat,81,1716,0,4,77,81,33,81
591,ElifTech,144,2444,0,6,138,144,39,144
592,Eliko,126,2686,0,6,120,126,47,126
593,Elinsys,32,518,0,2,30,32,12,32
594,ElixirTechnology,156,2851,0,11,145,156,50,156
595,Elmodis,36,837,0,0,36,36,17,36
596,ELSECorp,100,2552,0,7,93,100,40,100
597,ElsterHoneywell,25,536,0,2,23,25,10,25
598,EltanBV,20,387,0,2,18,20,12,20
599,EltecElektronikAG,119,2761,0,9,110,119,55,119
600,embedUR,36,734,0,0,36,36,14,36
601,EmbeeSoftwarePvtLtd,131,3103,0,8,123,131,47,131
602,EmbeverGmbH,26,363,0,0,26,26,7,26
603,EmcraftSystems,10,117,0,0,10,10,1,10
604,Emdoor,84,1329,0,1,83,84,28,84
605,Emitu,23,441,0,0,23,23,6,23
606,EMnify,263,4774,0,16,247,263,86,263
607,Emulate3DRockwellAutomation,124,2816,0,5,119,124,40,124
608,endiio,90,1723,0,6,84,90,27,90
609,EndressHauserGroup,132,2878,0,8,124,132,52,132
610,ENEA,75,1578,0,4,71,75,20,75
611,EnergyRM,40,71,0,0,40,40,8,40
612,EnerNOC,154,3300,0,8,146,154,50,154
613,Enging,96,2123,0,14,82,96,39,96
614,Engoal,36,601,0,3,33,36,17,36
615,ENISCO,87,1976,0,3,84,87,34,87
616,Enlight,62,1264,0,7,55,62,15,62
617,enModus,77,1317,0,5,72,77,28,77
618,Ennoconn,21,431,0,0,21,21,10,21
619,ENO8,35,627,2,1,32,35,17,35
620,EnOcean,209,3865,0,10,199,209,75,209
621,EnsoftCisco,127,2699,0,4,123,127,47,127
622,Entando,55,1004,0,0,55,55,11,55
623,Entrust,124,2301,0,7,117,124,32,124
624,Enviosystems,79,1873,0,5,74,79,28,79
625,Enviromon,25,553,0,5,20,25,14,25
626,EpiData,34,433,0,0,34,34,5,34
627,EpiSensor,39,750,0,0,39,39,12,39
628,Epson,218,4624,0,10,208,218,75,218
629,EpsonRobotsEpson,218,4624,0,10,208,218,75,218
630,EQuotaEnergy,34,559,0,1,33,34,18,34
631,Eridanis,41,801,0,1,40,41,14,41
632,ESCRYPTBosch,128,2375,0,5,123,128,38,128
633,Eseye,209,4283,0,7,202,209,87,209
634,eSightEnergy,83,1569,0,3,80,83,25,83
635,ESIGroup,42,753,0,0,42,42,12,42
636,EspressifSystems,27,507,0,2,25,27,7,27
637,Esri,13,209,0,0,13,13,6,13
638,ETrifectaSolutions,21,446,0,2,19,21,9,21
639,Etrol,18,490,0,1,17,18,9,18
640,EURADrives,132,2594,0,8,124,132,42,132
641,Euristiq,79,1415,0,3,76,79,22,79
642,EuroITGroup,134,2949,0,7,127,134,48,134
643,Eurotech,1,6,0,0,1,1,0,1
644,EventAlways,93,1881,0,7,86,93,31,93
645,Evercam,28,709,0,3,25,28,16,28
646,EverlightElectronics,34,744,0,3,31,34,17,34
647,EverlyticsDataScience,83,1692,0,7,76,83,30,83
648,Eversec,14,228,0,0,14,14,4,14
649,EVRYTHNG,150,3217,0,5,145,150,52,150
650,Evun,32,765,0,2,30,32,17,32
651,EwattTechnology,141,2829,0,7,134,141,39,140
652,eWONHMSIndustrialNetworksHMSNetworks,4,13,0,0,4,4,0,4
653,Exact,66,1395,0,5,61,66,30,66
654,ExarMaxlinear,54,1341,0,4,50,54,15,54
655,Excubate,116,2427,0,7,109,116,48,116
656,ExecutiveOrder,25,698,0,2,23,25,16,25
657,Exioms,67,1066,0,3,64,67,24,67
658,Exosite,20,311,0,3,17,20,6,20
659,ExotecSolutions,48,1086,0,1,47,48,20,48
660,EXPEMB,14,218,0,0,14,14,3,14
661,ExpertAppDevs,127,2667,0,14,113,127,63,127
662,ExtheriaGmbH,21,362,0,0,21,21,6,21
663,ExtremeEngineeringSolutionsIncXES,21,525,0,1,20,21,10,21
664,EyesightTechnologies,80,1707,0,4,76,80,40,80
665,F5,168,3518,0,5,163,168,65,168
666,FactanaComputingPvtLtd,69,1606,1,4,64,69,26,69
667,FactoryBucket,190,4112,0,13,177,190,66,189
668,FactoryFour,11,194,0,2,9,11,4,11
669,FairwayElectronicCoLtd,271,7480,0,8,263,271,128,271
670,FaltcomTelia,29,546,0,0,29,29,11,29
671,Fanuc,37,918,0,3,34,37,17,37
672,FarSouthNetworks,49,975,0,3,46,49,17,49
673,Fastable,46,949,0,4,42,46,14,46
674,Fastly,147,3353,0,11,136,147,51,147
675,FaststreamTechnologies,43,779,0,3,40,43,15,43
676,Fauya,30,605,0,0,30,30,13,30
677,FAVORIOT,96,1758,0,4,92,96,26,96
678,fazeZero,69,1506,0,5,64,69,27,69
679,Feabhas,59,1137,0,5,54,59,23,59
680,Feasycom,22,451,0,0,22,22,7,22
681,FederatedWireless,123,2169,0,11,112,123,32,123
682,FeroLabs,140,2490,0,6,134,140,59,140
683,Feynlabs,57,874,0,4,53,57,21,57
684,Fibocom,33,1031,0,1,32,33,13,33
685,FieldCircle,94,1775,0,7,87,94,28,94
686,FIFOOPTICS,6,69,0,1,5,6,3,6
687,FiiFoxconn,40,664,0,1,39,40,14,40
688,FiixSoftware,107,2352,0,5,102,107,43,107
689,Findustrial,45,965,0,1,44,45,19,45
690,Finisar,128,3301,0,10,118,128,48,128
691,FinListics,97,2018,0,5,92,97,23,97
692,FinoitTechnologies,86,1516,0,1,85,86,21,86
693,FireEye,49,824,0,2,47,49,21,49
694,Firetide,87,1933,0,6,81,87,41,87
695,FirichEnterprises,40,827,0,4,36,40,22,40
696,FirstLineSoftware,38,735,0,3,35,38,16,38
697,FisherSmith,46,822,0,1,45,46,18,46
698,Five9NetworkSystemsLLC,56,948,0,0,56,56,11,56
699,FiveAI,28,773,0,1,27,28,7,28
700,FlameTechnology,92,1970,0,6,86,92,45,92
701,FlatoakCoLtd,25,505,0,3,22,25,12,25
702,FleetSpaceTechnologies,86,1905,0,9,77,86,34,86
703,Flexciton,65,1350,0,2,63,65,21,65
704,FlexEm,24,680,0,1,23,24,10,24
705,Flexis,84,1650,0,1,83,84,25,84
706,Flextronic,204,3895,0,8,196,204,68,204
707,FlexwareInnovation,62,1166,0,1,61,62,23,62
708,Fliit,36,540,0,0,36,36,3,36
709,FLIR,105,2673,0,9,96,105,49,105
710,Flirtey,11,137,0,0,11,11,3,11
711,Floverio,71,1394,0,6,65,71,19,71
712,FluidmeshNetworksCisco,127,2699,0,4,123,127,47,127
713,FlukeNetworks,152,3919,0,7,145,152,56,152
714,Flutura,11,198,0,0,11,11,1,11
715,FocusWorks,35,546,0,3,32,35,18,35
716,Fogger,38,682,0,0,38,38,11,38
717,FogHorn,35,749,0,2,33,35,15,35
718,FORCAM,128,2478,0,10,118,128,50,128
719,ForesightRobotics,24,376,0,0,24,24,6,24
720,ForLeavesLtd,141,3539,0,13,128,141,49,141
721,ForlinxEmbeddedTechnologyCoLtd,1,3,0,0,1,1,0,1
722,Formlabs,119,2695,0,9,110,119,53,119
723,Fortinet,173,3834,0,7,166,173,56,173
724,FourFaith,32,614,0,3,29,32,12,32
725,FourFaithSmartPowerTechnologyCoLtd,10,164,0,0,10,10,1,10
726,Framos,374,7626,0,30,344,374,127,374
727,FraunhoferIOSB,124,2526,0,8,116,124,45,124
728,FreckleIoT,13,118,0,0,13,13,1,13
729,FreedomRobotics,87,1552,0,1,86,87,20,87
730,FriendlyTechnologies,67,1372,0,2,65,67,22,67
731,FTDIChip,75,1460,0,4,71,75,28,75
732,FujiElectric,22,575,0,4,18,22,11,22
733,Fujitsu,85,1721,0,4,81,85,31,85
734,FusionConnect,129,2177,0,9,120,129,38,129
735,FutureMoveAutomotive,103,1868,0,1,102,103,45,103
736,FYBR,66,1662,0,2,64,66,35,66
737,G7,12,196,0,1,11,12,6,12
738,GadgeonSystems,30,514,0,1,29,30,8,30
739,GAITronicsCorporation,5,41,0,0,5,5,0,5
740,GalaxyCore,59,1038,0,4,55,59,23,59
741,GallopEngineering,129,2981,0,8,121,129,50,128
742,GambitCommunications,8,154,0,0,8,8,0,8
743,GambitStream,38,677,0,1,37,38,15,38
744,Garmin,44,869,0,6,38,44,15,44
745,GarrettComBelden,11,186,0,1,10,11,6,11
746,Gauzy,109,2062,0,9,100,109,35,109
747,GeckoRobotics,21,344,0,0,21,21,11,21
748,GEDigitalGEGeneralElectric,77,1858,0,4,73,77,35,77
749,Geek,238,5290,0,15,223,238,80,238
750,Gelement,219,5281,0,12,207,219,89,219
751,GEMAnalytics,94,2536,0,12,82,94,47,94
752,GeneralCable,20,410,0,3,17,20,10,20
753,GeneralDynamics,61,1231,0,6,55,61,26,61
754,GeneralElectric,77,1858,0,4,73,77,35,77
755,GenericIntelligentMachines,297,6368,0,12,285,297,134,297
756,GenevaSystems,97,2255,2,4,91,97,33,97
757,Genpact,147,2952,0,12,135,147,47,147
758,GetacTechnologyCorporation,15,289,0,0,15,15,5,15
759,GetMyParking,54,1118,0,4,50,54,18,54
760,GHIElectronicsLLC,131,2728,0,5,126,131,38,131
761,Gigabyte,37,599,0,1,36,37,12,37
762,Gizwits,74,1447,0,3,71,74,25,74
763,Glartek,52,1164,0,6,46,52,22,52
764,Glassbeam,69,1618,1,1,67,69,26,69
765,GlideTechnology,162,3519,0,9,153,162,62,162
766,GlobalITAppInfoSolution,60,1404,1,6,53,60,25,60
767,GlobalLogic,150,3480,0,7,143,150,45,150
768,GlobalNavigationSystems,36,654,0,0,36,36,16,36
769,GlobalWalkers,78,1707,0,3,75,78,28,78
770,GlueCollaboration,95,1931,0,7,88,95,29,95
771,GOFOUNDERS,98,1678,0,3,95,98,30,98
772,GOLDENET,64,1073,0,2,62,64,29,64
773,Gooee,88,1630,0,10,78,88,35,88
774,GOPELelectronic,192,3441,1,6,185,192,61,192
775,Grabit,52,825,0,2,50,52,21,52
776,GrafanaLabs,157,3163,0,6,151,157,45,157
777,GrAIMatterLabs,7,112,0,0,7,7,4,7
778,GrammaTech,139,2730,0,11,128,139,43,139
779,GraniteMEDSystems,16,286,0,0,16,16,5,16
780,GRAPHISOFT,211,5522,0,14,197,211,97,211
781,Grayhill,65,1577,0,10,55,65,27,65
782,GreenHillsSoftware,57,1035,0,0,57,57,15,57
783,GreenKoncepts,49,1126,0,3,46,49,34,49
784,GreenRoadTechnologies,90,1887,0,6,84,90,39,90
785,GridConnect,47,734,0,2,45,47,17,47
786,GridPoint,89,1948,0,4,85,89,29,89
787,Groundupai,102,2240,0,5,97,102,33,102
788,GroupeRenault,56,1007,0,1,55,56,17,56
789,GroupIB,81,1355,0,3,78,81,27,81
790,GroveStreams,97,1467,0,4,93,97,20,97
791,GuardhatTechnologies,151,3503,0,15,136,151,59,151
792,GumstixInc,124,2278,0,7,117,124,40,124
793,GURUSSolutions,92,2026,0,12,80,92,37,92
794,H3CTechnologies,20,371,0,3,17,20,13,20
795,H3DynamicsHoldings,26,548,0,2,24,26,9,26
796,HABX,48,644,0,1,47,48,14,48
797,Hacarus,1,5,0,0,1,1,0,1
798,HaierGroupHaierGroup,217,4745,1,18,198,217,104,217
799,Hailo,245,4348,0,9,236,245,71,245
800,HAL24K,61,1414,0,5,56,61,35,61
801,HALOElectronics,65,1283,0,6,59,65,25,65
802,Haltian,53,846,0,1,52,53,16,53
803,HamLet,78,1498,0,4,74,78,32,78
804,HammondManufacturing,10,159,0,0,10,10,5,10
805,HancomMDS,53,1124,0,4,49,53,21,53
806,HanweiElectronics,116,2859,0,6,110,116,55,116
807,HappiestMindsTechnologies,63,1249,0,5,58,63,27,63
808,HarkSystems,34,628,0,3,31,34,14,34
809,HarmanSamsungSamsungElectronics,122,2244,0,7,115,122,35,122
810,HARTINGTechnologyGroup,141,2566,0,9,132,141,54,141
811,HCBBatteryCoLtd,5,129,0,0,5,5,2,5
812,HDataSystems,47,841,0,2,45,47,17,47
813,HDIM,60,1307,0,2,58,60,18,60
814,HectronicAB,67,1409,0,6,61,67,21,67
815,Helium,84,1604,0,9,75,84,38,84
816,HenningSoftwareInc,22,330,0,0,22,22,3,22
817,Heptagon,48,823,0,2,46,48,15,48
818,HERAMES,48,943,0,2,46,48,19,48
819,Heroku,117,2217,0,7,110,117,63,117
820,Herow,110,2531,0,9,101,110,40,110
821,Hezhisheng,21,430,0,0,21,21,5,21
822,HiAR,70,1290,0,8,62,70,29,70
823,HiddenBrainsInfotech,61,1084,0,6,55,61,20,61
824,HIDGlobal,199,3803,0,14,185,199,63,199
825,HiGTek,66,1105,0,3,63,66,19,66
826,HiKoB,81,1712,0,0,81,81,27,81
827,Hikvision,70,1482,0,4,66,70,33,70
828,Hillsun,41,846,0,0,41,41,18,41
829,HilscherSystemAutomation,128,2363,0,9,119,128,45,128
830,HILTI,83,1910,0,0,83,83,34,83
831,HirschmannBelden,1,1,0,0,1,1,0,1
832,Hitachi,29,778,0,3,26,29,17,29
833,HitachiVantaraHitachi,464,11088,0,13,451,464,185,464
834,HitSeed,10,95,0,1,9,10,1,10
835,HiveMQ,134,2648,0,6,128,134,45,134
836,HMSNetworks,11,18,0,0,11,11,1,11
837,HodusoftPvtLtd,19,292,0,0,19,19,5,19
838,HolisticsSoftware,105,2384,0,8,97,105,43,105
839,HollySys,20,437,0,1,19,20,11,20
840,Holmusk,30,743,0,6,24,30,16,30
841,HoloBuilder,24,355,0,0,24,24,5,24
842,Hologram,152,3135,0,8,144,152,49,152
843,HoloLight,117,2062,0,7,110,117,48,117
844,HoltIntegratedCircuits,26,492,0,1,25,26,15,26
845,Homebase,167,3442,0,14,153,167,69,167
846,HondaMotor,86,2053,0,6,80,86,28,86
847,Honeywell,1,3,0,0,1,1,0,1
848,HoneywellProcessSolutionsHoneywell,1,3,0,0,1,1,0,1
849,HopelandTechnologies,1,20,0,0,1,1,0,1
850,HoustonPlasticProducts,26,409,0,2,24,26,13,26
851,HualongXundaInformationTechnologyCoLtd,31,687,0,2,29,31,11,31
852,Huawei,113,2220,0,12,101,113,48,113
853,HuaweiCloudHuawei,114,2370,0,7,107,114,40,114
854,HuazhongCNC,2,33,0,0,2,2,0,2
855,HUBERSUHNER,61,1621,0,1,60,61,29,61
856,HuiWuTechnologies,113,2220,0,12,101,113,48,113
857,Humatics,113,2003,0,4,109,113,29,113
858,HumawareEKEElectronics,7,131,0,1,6,7,2,7
859,HuynewTechnology,597,12032,0,10,587,597,292,597
860,Hyperstone,202,5076,0,11,191,202,76,202
861,Hyster,230,4690,0,11,219,230,73,230
862,HysterYale,230,4690,0,11,219,230,73,230
863,IA3,57,1178,1,3,53,57,23,57
864,IBM,185,4018,0,11,174,185,77,185
865,IBMWatsonIBM,185,4018,0,11,174,185,77,185
866,ICONICSINC,113,2395,0,9,104,113,42,113
867,ICOP,138,3855,0,3,135,138,63,138
868,ICTAutomatiseringNV,92,1579,0,4,88,92,25,92
869,iDaB,36,834,0,1,35,36,10,36
870,IdealTech,10,180,0,0,10,10,5,10
871,Idein,23,596,0,1,22,23,10,23
872,IDM,19,511,0,4,15,19,15,19
873,IEIIntegration,139,3067,0,9,130,139,55,139
874,ifmefector,127,2536,0,6,121,127,42,127
875,IgnitePrism,90,1838,1,2,87,90,29,90
876,IGZY,40,817,0,1,39,40,9,40
877,ImbriosSystems,9,132,0,0,9,9,1,9
878,IMEC,59,971,0,5,54,59,21,59
879,IMIPrecisionEngineering,55,1306,0,4,51,55,21,55
880,Imperva,52,918,0,0,52,52,18,52
881,Implico,156,3095,0,6,150,156,54,156
882,IMRONCorporation,20,356,0,0,20,20,6,20
883,IMSolution,139,3129,0,3,136,139,46,139
884,Imubit,66,1229,0,2,64,66,15,66
885,InCar,8,11,0,0,8,8,1,8
886,IndeemaSoftware,60,1237,0,9,51,60,24,60
887,IndegyTenable,188,3808,0,7,181,188,62,188
888,IndependentSecurityEvaluators,36,555,0,1,35,36,11,36
889,INDICS,6,109,0,0,6,6,2,6
890,IndicusSoftware,20,430,0,1,19,20,5,20
891,IndieSemiconductor,7,108,0,0,7,7,0,7
892,IndigoVerge,52,1046,0,8,44,52,20,52
893,InductiveAutomation,37,779,0,1,36,37,10,37
894,InduSol,165,2942,0,6,159,165,62,165
895,IndustrialAnalyticsBerlinIAB,27,374,0,3,24,27,12,27
896,IndustrialInternetConsortiumIIC,28,710,0,0,28,28,10,28
897,IndustrialNetworkSystems,68,1468,0,1,67,68,20,68
898,IndustrialVisionSystems,63,1110,0,1,62,63,20,63
899,IndustryCorps0,19,302,0,1,18,19,8,19
900,INEEJICoLtd,23,240,0,0,23,23,6,23
901,INEOSENSE,83,1243,0,4,79,83,22,83
902,InetSoftTechnology,16,331,0,0,16,16,5,16
903,Infineon,2,8,0,0,2,2,0,2
904,infinimesh,147,3187,0,7,140,147,49,147
905,InfiniteOpenSourceSolutionsLLP,10,158,0,1,9,10,3,10
906,InfiniteRFIDtechnologycolimited,102,2285,0,6,96,102,36,102
907,InfiniteT3ch,226,5052,0,5,221,226,78,226
908,InfiniteUptime,59,1015,0,2,57,59,17,59
909,infiswift,77,2077,0,5,72,77,38,77
910,Inflectra,93,2034,0,5,88,93,44,93
911,Inflowmatix,61,934,0,2,59,61,19,61
912,Infoblox,158,3381,0,10,148,158,64,158
913,Infor,121,2777,0,17,104,121,52,121
914,Informatica,143,3434,0,8,135,143,48,143
915,InfortrendTechnologyInc,53,1181,0,1,52,53,18,53
916,Infosys,78,1632,0,1,77,78,31,78
917,InfoteamSoftwareSuzhou,196,3606,0,11,185,196,64,196
918,Ingenu,21,474,0,1,20,21,10,21
919,Inglobe,100,2071,0,5,95,100,33,100
920,IngramMicro,9,171,0,0,9,9,3,9
921,INGSHI,51,1254,0,4,47,51,26,51
922,Inhand,70,1244,0,5,65,70,25,70
923,InitialState,42,1215,0,2,40,42,13,42
924,Inlaylink,23,417,0,0,23,23,8,23
925,Inmarsat,135,2954,0,2,133,135,43,135
926,Innodisk,38,822,0,0,38,38,21,38
927,INNOTECH,53,980,0,3,50,53,15,53
928,Innovaide,27,518,0,1,26,27,7,27
929,Innovapptive,59,1274,0,5,54,59,32,59
930,InoNetComputer,43,916,0,0,43,43,13,43
931,INOSIM,117,2429,0,4,113,117,43,117
932,InovaceTechnologies,25,458,0,0,25,25,12,25
933,InovanceTechnology,266,7370,0,9,257,266,119,266
934,Inpixon,133,2862,0,5,128,133,43,133
935,INRIX,173,3441,0,10,163,173,57,173
936,Inseego,282,7372,0,14,268,282,107,282
937,InsightEnterprises,50,1201,0,3,47,50,25,50
938,Inspection2,87,1985,0,7,80,87,25,87
939,Inspectorio,81,1504,0,6,75,81,33,81
940,Inspirient,12,290,0,1,11,12,6,12
941,InsydeSoftware,29,537,0,2,27,29,10,29
942,INSYSicom,121,2170,0,12,109,121,44,121
943,IntegraSources,38,554,0,1,37,38,5,38
944,IntegrateIT,13,154,0,0,13,13,5,13
945,Intel,207,4891,0,9,198,207,80,207
946,Intelind,207,4891,0,9,198,207,80,207
947,IntelliFluxControls,49,1028,0,5,44,49,13,49
948,IntelligenceTechsolInc,43,729,0,2,41,43,14,43
949,intellinium,150,3173,0,16,134,150,62,150
950,IntelliSenseio,46,861,0,0,46,46,21,46
951,IntellistrideTechnologies,19,367,0,1,18,19,8,19
952,IntellisysConsulting,146,3144,0,10,136,146,65,146
953,IntematixCorporation,4,38,0,0,4,4,0,4
954,IntentoDesign,40,725,0,0,40,40,9,40
955,Intermatic,32,453,0,0,32,32,7,32
956,INTERPOLATION,46,766,0,2,44,46,16,46
957,INTIntelligenceampTelecom,244,5703,0,5,239,244,114,244
958,Intraratio,38,914,0,1,37,38,10,38
959,Invengo,80,1631,1,3,76,80,30,80
960,InvensysSchneiderElectric,23,343,0,0,23,23,5,23
961,Inventec,18,285,0,0,18,18,6,18
962,Invixium,168,4263,0,10,158,168,55,168
963,ioNetworks,138,3353,0,11,127,138,56,138
964,ionSignOy,19,223,0,0,19,19,4,19
965,IoT83,90,1680,0,2,88,90,28,90
966,IOTA,80,1585,0,5,75,80,20,80
967,IoTblue,27,327,0,0,27,27,0,27
968,IoTConnectIndustrialAutomationSolution,27,469,0,1,26,27,8,27
969,IoTDevLabs,207,4411,0,9,198,207,83,207
970,IOTech,38,688,0,2,36,38,13,38
971,IoTEdge,55,977,0,0,55,55,30,55
972,IoTeX,97,2105,0,11,86,97,39,97
973,IOTFactory,68,1224,0,0,68,68,26,68
974,IOTHINKSOLUTIONS,9,217,0,1,8,9,6,9
975,IoTium,44,803,0,2,42,44,13,44
976,IoTivity,10,145,0,0,10,10,4,10
977,IOTomationEcotech,14,186,0,0,14,14,5,14
978,IoTONEAAcademy,82,1662,0,7,75,82,35,82
979,iOTOS,109,2136,0,3,106,109,34,109
980,IoTSystems,68,1224,0,0,68,68,26,68
981,IOTTeknoloji,68,1224,0,0,68,68,26,68
982,IOTW,70,1473,0,2,68,70,25,70
983,IQMS,28,704,0,2,26,28,18,28
984,Ircona,77,1390,0,4,73,77,27,77
985,iRhythmTechnologies,102,2457,0,5,97,102,37,102
986,iRise,37,905,0,1,36,37,18,37
987,irobot,120,2631,0,3,117,120,37,120
988,iTACSoftwareAGDurr,32,549,0,1,31,32,12,32
989,Itexus,212,5319,0,8,204,212,95,212
990,ITWLinx,27,575,0,4,23,27,15,27
991,IvarJacobson,14,189,0,0,14,14,5,14
992,Iven,59,1018,0,0,59,59,20,59
993,IXON,53,915,0,4,49,53,17,53
994,Jabil,173,3585,0,10,163,173,66,173
995,Jacobs,96,2195,0,8,88,96,32,96
996,JanusRemoteCommunicationsConnorWinfieldCorporation,46,1051,0,1,45,46,13,46
997,jelastic,7,98,0,0,7,7,1,7
998,JeraSoft,62,1160,0,5,57,62,25,62
999,JimiIoT,66,1102,0,5,61,66,33,66
1000,Jingzhi,23,431,0,0,23,23,11,23
1001,JIYIUAV,15,268,0,0,15,15,4,15
1002,JKLComponents,9,146,0,1,8,9,3,9
1003,JohansonDielectrics,53,1332,0,3,50,53,21,53
1004,JollyTechnologies,51,1115,0,4,47,51,27,51
1005,JOUAV,55,1026,0,2,53,55,21,55
1006,Joyent,78,2028,0,11,67,78,42,78
1007,JTT,16,233,0,0,16,16,2,16
1008,Jujotech,127,2817,0,8,119,127,43,127
1009,JuniperNetworks,94,1916,0,2,92,94,28,94
1010,justin,128,2393,0,9,119,128,40,128
1011,JZTech,36,684,0,2,34,36,18,36
1012,K2,178,4179,0,10,168,178,62,178
1013,K2data,60,1160,0,1,59,60,19,60
1014,KaaIoTTechnologies,56,1258,0,2,54,56,21,56
1015,Kaazing,66,1242,0,5,61,66,27,66
1016,KAISI,18,340,0,0,18,18,3,18
1017,kajeet,70,1546,0,12,58,70,34,70
1018,Kalewa,37,583,0,3,34,37,18,37
1019,Kalkitech,45,876,0,1,44,45,15,45
1020,Kaloom,58,1059,0,3,55,58,22,58
1021,Kamstrup,58,840,0,1,57,58,8,58
1022,Kando,29,554,0,0,29,29,8,29
1023,KarambaSecurity,147,3080,0,9,138,147,66,147
1024,KawasakiHeavyIndustries,29,428,0,0,29,29,4,29
1025,KayaDevAI,34,638,0,0,34,34,9,34
1026,KBCNetworks,78,1648,0,4,74,78,40,78
1027,KblerGroup,66,1456,0,3,63,66,33,66
1028,KEB,34,610,0,1,33,34,14,34
1029,KEBA,207,5197,0,5,202,207,68,207
1030,KeepgoLtd,96,1688,0,3,93,96,24,96
1031,KelltonTechSolutions,88,1920,0,9,79,88,42,88
1032,KEMETCorporation,204,3970,0,12,192,204,60,204
1033,KepwarePTC,77,1514,0,6,71,77,42,77
1034,KETOS,73,1309,0,6,67,73,19,73
1035,KeyASIC,294,7043,0,5,289,294,134,294
1036,KeystoneElectronics,65,1326,0,4,61,65,27,65
1037,Kigen,99,2435,0,7,92,99,31,99
1038,Kiloway,63,1308,0,5,58,63,29,63
1039,Kingbright,16,343,0,1,15,16,6,16
1040,Kingdee,6,83,0,0,6,6,1,6
1041,KingsoftCloud,150,3520,0,13,137,150,66,150
1042,KingstonTechnology,239,5181,0,13,226,239,71,239
1043,KITOVSystems,15,338,0,0,15,15,11,15
1044,KituSystems,124,2374,0,3,121,124,32,124
1045,Kiunsys,124,2653,0,16,108,124,55,124
1046,Kiwifarm,35,471,0,1,34,35,11,35
1047,Klocwork,67,968,0,4,63,67,26,67
1048,Kloudq,60,1428,0,3,57,60,20,60
1049,KMCControls,272,6344,0,14,258,272,90,272
1050,KnowBe4,117,2383,0,3,114,117,37,117
1051,KOASpeerElectronics,75,2216,0,7,68,75,36,75
1052,Kolmostar,16,287,0,0,16,16,5,16
1053,Konkerlabs,40,671,0,0,40,40,14,40
1054,KonstantInfosolutions,16,369,0,1,15,16,6,16
1055,KontrolEnergy,25,400,0,0,25,25,6,25
1056,KontronSampTGroup,25,524,0,1,24,25,8,25
1057,KONUX,29,543,0,2,27,29,9,29
1058,KoreaTelecom,125,2718,0,13,112,125,41,125
1059,KOREWireless,80,1758,0,5,75,80,30,80
1060,KoyoElectronics,21,564,0,2,19,21,14,21
1061,Krista,89,2287,1,3,85,89,34,89
1062,Kubermatic,209,3768,0,8,201,209,65,209
1063,KudelskiSecurity,97,2387,0,6,91,97,51,97
1064,KUKAAG,136,2151,0,4,132,136,43,136
1065,KuleTech,103,2372,0,3,100,103,32,103
1066,KuraTechnologies,57,1248,0,8,49,57,28,57
1067,KylandTechnology,24,420,0,0,24,24,9,24
1068,Lab651,79,1601,0,1,78,79,24,79
1069,Laird,70,1403,0,2,68,70,22,70
1070,LampTTechnologyServices,33,472,0,2,31,33,7,33
1071,LanguangInnovativeTechnology,109,2382,0,4,105,109,29,109
1072,LannerElectronics,80,1409,0,2,78,80,30,80
1073,LappGroup,84,1518,0,1,83,84,24,84
1074,Laxcen,28,643,0,3,25,28,16,28
1075,Leanway,42,821,0,1,41,42,15,42
1076,Legrand,34,370,0,0,34,34,8,34
1077,LeicaGeosystemsHexagon,68,1415,0,4,64,68,21,68
1078,Leverege,89,2322,0,2,87,89,32,89
1079,Leviton,163,3382,0,6,157,163,61,163
1080,Lewei50,112,2387,0,6,106,112,31,112
1081,LexComputech,74,1678,0,2,72,74,27,74
1082,Lgcx,135,2854,0,10,125,135,49,135
1083,Libelium,64,948,0,1,63,64,16,64
1084,Librestream,29,524,0,1,28,29,11,29
1085,Lidar360,40,752,0,5,35,40,18,40
1086,LiebherrGroup,92,1724,0,5,87,92,35,92
1087,LifeSignals,58,1415,0,3,55,58,27,58
1088,Lightbend,135,3168,0,10,125,135,46,135
1089,LINAK,104,1994,0,4,100,104,26,104
1090,Lingxi,17,172,0,0,17,17,4,17
1091,LinkLabs,80,1706,0,2,78,80,36,80
1092,LinuxFoundation,135,3832,0,20,115,135,50,135
1093,LiteOn,30,676,1,1,28,30,7,30
1094,LitmusAutomation,26,447,0,0,26,26,6,26
1095,Littelfuse,46,757,0,3,43,46,21,46
1096,Litum,74,1581,0,8,66,74,33,74
1097,LivePerson,108,2600,0,14,94,108,55,108
1098,LivwizeSmartSolutions,47,1200,0,4,43,47,21,47
1099,LKHPrecicon,35,785,0,0,35,35,14,35
1100,LLamasoft,151,3939,0,6,145,151,59,151
1101,Lochn,137,2868,0,8,129,137,40,136
1102,LockheedMartin,185,3833,0,10,175,185,52,185
1103,LogicAppsTechnologiesIndiaPvtLimited,2,48,0,0,2,2,1,2
1104,Logicline,50,962,0,2,48,50,16,50
1105,LogiNext,2,43,0,0,2,2,0,2
1106,Lokad,40,683,0,2,38,40,11,40
1107,LongcomIoT,115,2187,0,3,112,115,25,115
1108,LongsungTechnology,79,1621,0,9,70,79,42,79
1109,Losant,64,1069,0,1,63,64,18,64
1110,LRESolutions,111,2541,0,1,110,111,36,111
1111,LTiMotion,30,787,0,3,27,30,15,30
1112,Luat,29,501,0,2,27,29,18,29
1113,LucataCorporation,151,2997,0,11,140,151,44,151
1114,Lucid,8,81,0,0,8,8,1,8
1115,LumenRadio,71,1354,0,1,70,71,26,71
1116,LumexElectricalampLightingSolutions,31,622,0,4,27,31,13,31
1117,Luner,67,1116,0,0,67,67,17,67
1118,LUTZBOT,32,549,0,2,30,32,9,32
1119,Luxoft,141,3160,0,12,129,141,59,141
1120,LynxSoftwareTechnologies,139,2766,0,6,133,139,39,139
1121,M1Limited,75,1768,0,6,69,75,30,75
1122,M2Intelligence,60,958,0,2,58,60,17,60
1123,M2MOne,72,1252,0,0,72,72,9,72
1124,MAANA,102,2200,0,4,98,102,48,102
1125,Machfu,41,734,0,2,39,41,14,41
1126,MachineMetrics,96,2500,1,5,90,96,42,96
1127,MACOM,52,1024,0,2,50,52,13,52
1128,Magicplan,67,1247,0,4,63,67,23,67
1129,MagnaChipSemiconductor,49,1064,0,4,45,49,15,49
1130,Mainflux,16,318,0,0,16,16,6,16
1131,MaisijieNetwork,60,1198,0,4,56,60,13,60
1132,MakinaRocks,57,1333,0,3,54,57,33,57
1133,Malong,136,2924,0,7,129,136,45,136
1134,MaluInnovation,21,493,0,1,20,21,7,21
1135,MampMSoftware,89,1640,0,4,85,89,34,89
1136,Manifold,132,2498,0,11,121,132,60,132
1137,MANNHUMMEL,136,2537,0,10,126,136,39,136
1138,ManthaGroupPtyLtd,18,335,0,2,16,18,5,18
1139,Manulism,24,321,0,1,23,24,6,24
1140,MarconiWirelessInc,97,2074,0,2,95,97,22,97
1141,Mariner,160,3503,0,14,146,160,61,160
1142,MarvellTechnologyGroup,66,1634,0,6,60,66,24,66
1143,MassAutomation,14,316,0,1,13,14,8,14
1144,MasternautMichelin,94,2406,0,8,86,94,38,94
1145,MatchX,218,4924,0,8,210,218,78,218
1146,Materialise,46,1276,0,1,45,46,21,46
1147,MathWorks,204,4259,0,15,189,204,71,204
1148,Matrox,23,367,0,2,21,23,5,23
1149,Matternet,24,464,0,0,24,24,11,24
1150,MavenMachines,20,444,0,1,19,20,9,20
1151,MaxbyteTechnologies,50,1062,0,4,46,50,11,50
1152,Maxion,70,1711,0,2,68,70,31,70
1153,MaxLinear,54,1341,0,4,50,54,15,54
1154,MaxonMotor,3,43,0,0,3,3,2,3
1155,McAfee,858,20181,0,31,827,858,330,858
1156,mCloud,93,1657,0,5,88,93,37,93
1157,MEAutomationProjectsMitsubishiElectric,99,2074,0,5,94,99,29,99
1158,MedCrypt,33,731,0,4,29,33,11,33
1159,MediaTek,88,2027,0,3,85,88,25,88
1160,Medigate,106,1774,0,7,99,106,32,106
1161,MediumOne,109,2401,0,7,102,109,33,109
1162,MeganovaDigitalTechnologiesAB,7,88,0,0,7,7,2,7
1163,MellanoxNVIDIA,68,1202,0,3,65,68,18,68
1164,MEMEX,38,677,0,1,37,38,15,38
1165,MEMSIC,97,2048,1,14,82,97,49,97
1166,MemSQL,59,1328,0,7,52,59,24,59
1167,Mender,216,5046,0,18,198,216,93,216
1168,MentorGraphicsSiemens,102,2396,0,6,96,102,38,102
1169,MercedesBenz,102,1953,0,3,99,102,28,102
1170,MercurySystems,41,746,0,2,39,41,14,41
1171,Meshify,21,427,0,0,21,21,11,21
1172,MeshSystems,109,1919,0,6,103,109,29,109
1173,mesurio,38,742,0,3,35,38,13,38
1174,METIM2MIndia,18,395,0,0,18,18,9,18
1175,Metrikus,128,2749,0,2,126,128,37,128
1176,METTLERTOLEDO,86,1967,0,6,80,86,28,86
1177,METZCONNECTUSAInc,149,2685,0,3,146,149,37,149
1178,Michelin,123,2462,0,3,120,123,41,123
1179,MicrochipTechnology,79,1393,0,1,78,79,30,79
1180,MicronTechnology,144,3172,0,11,133,144,41,144
1181,MicroscanOmronIndustrialAutomation,35,612,0,4,31,35,10,35
1182,MicroSec,184,4352,0,17,167,184,87,184
1183,MicrosemiCorporation,116,2652,0,9,107,116,37,116
1184,Microsoft,1324,29734,0,164,1160,1324,678,1324
1185,MicrosoftAzureMicrosoft,1324,29734,0,164,1160,1324,678,1324
1186,MidAtlanticRuggedSystems,57,1102,0,5,52,57,14,57
1187,MidokuraSony,26,333,0,0,26,26,9,26
1188,MilestoneSystems,178,4133,0,10,168,178,77,178
1189,MillennialNet,93,1904,0,3,90,93,27,93
1190,MINGLabs,118,2432,0,6,112,118,41,118
1191,MingsealRobotics,137,3498,0,14,123,137,62,137
1192,MinnovationTechnologies,35,627,0,3,32,35,17,35
1193,Mirantis,61,1575,0,10,51,61,25,61
1194,MIRMASHIN,94,2203,0,6,88,94,30,94
1195,miRobot,70,1454,0,2,68,70,31,70
1196,MisurioAG,38,756,0,0,38,38,15,38
1197,Miteno,75,1604,0,7,68,75,29,75
1198,MitsubishiElectric,52,1069,0,6,46,52,26,52
1199,MLITSolutions,13,244,0,2,11,13,6,13
1200,MobicaLimited,81,1277,0,1,80,81,22,81
1201,MobileyeIntel,149,3839,0,9,140,149,59,149
1202,Mobiloitte,60,1133,0,1,59,60,20,60
1203,Mocana,90,2111,0,4,86,90,40,90
1204,MODE,106,2469,0,12,94,106,37,106
1205,Mojix,74,1649,0,4,70,74,32,74
1206,Molex,69,1958,0,1,68,69,46,69
1207,Monixo,20,528,0,1,19,20,12,20
1208,Monnit,124,3235,0,15,109,124,64,124
1209,Monolith,160,3517,0,4,156,160,51,160
1210,MooMa,37,650,0,4,33,37,21,37
1211,Moresoft,50,1037,0,5,45,50,17,50
1212,MotionMiners,264,5321,0,4,260,264,96,264
1213,MotorolaSolutions,225,5478,0,13,212,225,80,225
1214,Movella,107,2173,0,5,102,107,36,107
1215,MovilitasConsulting,231,5037,0,11,220,231,89,231
1216,MovimentoAcquiredbyDelphiAutomotivePLCAptiv,16,383,0,2,14,16,9,16
1217,MOVUS,59,1332,0,5,54,59,19,59
1218,Mphasis,57,1377,0,6,51,57,26,57
1219,mPrest,43,988,0,2,41,43,23,43
1220,MSCTechnologies,51,788,0,4,47,51,22,51
1221,muhammadAzim,26,216,0,0,26,26,2,26
1222,MUJIN,12,356,0,1,11,12,6,12
1223,MultiTechSystems,38,700,0,1,37,38,12,38
1224,MurataManufacturing,110,2211,0,4,106,110,29,110
1225,MXCHIP,65,1862,0,6,59,65,26,65
1226,MxD,54,1128,0,3,51,54,16,54
1227,MYSPHERA,34,739,0,3,31,34,15,34
1228,N3N,13,177,0,0,13,13,1,13
1229,NandaAutomation,39,786,0,2,37,39,16,39
1230,NanoLockSecurity,38,670,0,4,34,38,11,38
1231,NanopreciseSciCorp,59,1077,0,0,59,59,19,59
1232,NanotronInpixon,151,2415,0,3,148,151,59,151
1233,NASoftware,7,98,0,0,7,7,1,7
1234,NATIONELTD,175,3639,0,6,169,175,58,175
1235,Nauto,128,2715,0,23,105,128,58,128
1236,Navisite,8,99,0,0,8,8,2,8
1237,nCinga,12,302,0,0,12,12,4,12
1238,NCSTechnologies,33,601,0,3,30,33,12,33
1239,NearMissManagementNM,30,436,0,0,30,30,5,30
1240,NebbioloTechnologies,13,128,0,0,13,13,3,13
1241,NebeskieLabs,52,941,0,1,51,52,21,52
1242,NEC,40,802,0,0,40,40,17,40
1243,NeebalTechnologies,63,1060,0,3,60,63,18,63
1244,Neewee,83,1485,0,3,80,83,23,83
1245,NEFAB,71,1420,0,6,65,71,30,71
1246,Neo4j,35,771,0,3,32,35,13,35
1247,NEOWAYTECHNOLOGY,27,624,0,3,24,27,9,27
1248,NestAlphabet,186,4223,0,29,157,186,100,186
1249,NetApp,217,5219,1,23,193,217,79,217
1250,Netdata,155,3370,0,17,138,155,67,155
1251,NETeIndia,45,820,0,1,44,45,11,45
1252,NETGEAR,35,586,0,0,35,35,9,35
1253,NetModule,92,1844,0,2,90,92,38,92
1254,Netronome,5,91,0,0,5,5,1,5
1255,Netsurion,35,637,0,4,31,35,16,35
1256,NetworkAllies,67,1340,0,5,62,67,26,67
1257,NeuralConcept,18,301,0,4,14,18,8,18
1258,Neustar,224,5211,0,32,192,224,88,224
1259,NewBoundaryTechnologies,22,376,0,0,22,22,6,22
1260,NewCoreTech,45,727,0,1,44,45,15,45
1261,NewDimensionsSystems,29,594,0,1,28,29,9,29
1262,NewGenerationSensors,3,34,0,0,3,3,1,3
1263,NewhopeData,127,2786,0,12,115,127,44,127
1264,Newstart,5,102,0,0,5,5,0,5
1265,NexappTechnologies,61,1657,0,0,61,61,25,61
1266,NEXCOM,20,402,0,0,20,20,5,20
1267,Nexgrid,38,837,0,3,35,38,18,38
1268,NEXIONACONNECTOCRATS,9,100,0,0,9,9,2,9
1269,Nexsis,93,2033,0,4,89,93,30,93
1270,Nextbillionai,78,1722,0,5,73,78,26,78
1271,NextNineHoneywellInternational,1,3,0,0,1,1,0,1
1272,NGRAINCorporationmCloud,4,44,0,0,4,4,0,4
1273,NI,156,3417,1,5,150,156,54,156
1274,nicheBees,60,1370,0,3,57,60,24,60
1275,Nikon,136,3270,0,7,129,136,47,136
1276,NIoTEK,40,709,0,0,40,40,13,40
1277,NOALabs,65,1508,0,4,61,65,24,65
1278,NodkaAutomation,72,1264,0,7,65,72,23,72
1279,NoMagic,279,6444,0,12,267,279,107,279
1280,NoodleAnalytics,90,2079,0,6,84,90,35,90
1281,NordicSemiconductor,76,1236,0,0,76,76,16,76
1282,NortonLifeLockBroadcom,8,197,0,1,7,8,5,8
1283,NozomiNetworks,122,2462,0,10,112,122,46,122
1284,NPM,79,1397,0,5,74,79,33,79
1285,NTTData,22,522,0,1,21,22,7,22
1286,NuboSoftware,43,950,0,2,41,43,16,43
1287,NucleusVision,26,476,0,1,25,26,6,26
1288,Numem,234,4384,0,13,221,234,83,234
1289,NuSpace,70,1534,0,1,69,70,32,70
1290,Nutanix,117,3218,0,9,108,117,53,117
1291,NUUO,11,166,0,0,11,11,2,11
1292,nVent,125,2832,0,3,122,125,42,125
1293,NVIDIA,68,1202,0,3,65,68,18,68
1294,NVT,12,240,0,0,12,12,1,12
1295,NXPSemiconductors,69,1073,0,0,69,69,19,69
1296,Nxxtech,84,1730,0,8,76,84,30,84
1297,ObjectFrontierSoftware,76,1584,0,4,72,76,39,76
1298,Objectivity,55,1085,0,2,53,55,18,55
1299,OblongIndustries,151,3457,0,1,150,151,48,151
1300,OceanDataSystems,44,692,0,1,43,44,16,44
1301,OctavoLabs,73,1482,0,6,67,73,28,73
1302,OctobluCitrix,30,428,0,0,30,30,8,30
1303,OdenTechnologies,93,1586,0,4,89,93,23,93
1304,OEEsystems,26,500,0,2,24,26,11,26
1305,Okapi,97,2085,0,7,90,97,30,97
1306,OliviaWireless,21,400,0,1,20,21,6,21
1307,OlympusCorporation,145,3252,0,3,142,145,42,145
1308,OlympusSkyTechnologies,145,3252,0,3,142,145,42,145
1309,OMEGAEngineering,14,226,0,0,14,14,4,14
1310,Omexell,44,990,0,1,43,44,16,44
1311,Omni3D,24,398,0,2,22,24,9,24
1312,OmniID,70,1483,0,3,67,70,22,70
1313,OmniSci,78,1447,0,6,72,78,30,78
1314,OmronAdeptTechnologyIncOmronIndustrialAutomation,84,1572,0,4,80,84,26,84
1315,OmronIndustrialAutomation,35,612,0,4,31,35,10,35
1316,Oncite,40,714,0,2,38,40,15,40
1317,ONENet,40,768,0,0,40,40,8,40
1318,OneNetwork,52,1039,0,5,47,52,18,52
1319,onetelecomme,73,1410,0,2,71,73,24,73
1320,OnFarmSystemsSWIIM,28,658,0,1,27,28,10,28
1321,OnionCorporation,39,696,0,10,29,39,20,39
1322,ONPASSIVELLC,66,1555,0,7,59,66,36,66
1323,ONSemiconductor,186,4329,0,8,178,186,52,186
1324,OodlesAI,40,531,0,1,39,40,6,40
1325,OpenAILab,50,1233,1,2,47,50,17,50
1326,OpenDNSCisco,127,2699,0,4,123,127,47,127
1327,OpenLegacy,123,2798,0,12,111,123,41,123
1328,Openpath,126,2752,0,22,104,126,70,126
1329,OpenRemote,18,315,0,3,15,18,8,18
1330,OpenStack,13,177,0,0,13,13,4,13
1331,OpenSynergy,136,2556,0,12,124,136,50,136
1332,Opentrends,49,1457,0,1,48,49,25,49
1333,OPERIT,144,2248,0,5,139,144,66,144
1334,Opiron,80,1634,0,4,76,80,26,80
1335,OptekTechnology,72,1472,0,3,69,72,22,72
1336,Opti,94,2029,0,4,90,94,30,94
1337,OptimalDesign,21,311,0,2,19,21,7,21
1338,OptimumPath,271,6772,0,29,242,271,103,271
1339,OptimusRide,61,1165,0,3,58,61,23,61
1340,Opto22,25,564,0,6,19,25,15,25
1341,Oracle,149,3655,0,10,139,149,53,149
1342,Orange,25,512,0,0,25,25,12,25
1343,ORBCOMM,106,2480,0,5,101,106,45,106
1344,Orbiwise,63,843,0,0,63,63,15,63
1345,Orientech,42,746,0,2,40,42,15,42
1346,OrigoElectronic,41,701,0,1,40,41,17,41
1347,OrionM2M,44,823,0,1,43,44,15,44
1348,OSIsoft,182,3720,0,10,172,182,69,182
1349,Osperity,110,1988,0,3,107,110,29,110
1350,OsramSemiconductors,76,1182,0,5,71,76,24,76
1351,Ossisto365,14,236,0,0,14,14,4,14
1352,OtherMachineCo,96,2500,1,5,90,96,42,96
1353,oTMS,18,385,0,0,18,18,7,18
1354,OtoSenseAnalogDevices,29,597,0,1,28,29,6,29
1355,OTTOMotors,42,670,0,2,40,42,12,42
1356,OuEEnergyTechnology,52,1111,0,3,49,52,26,52
1357,Ouster,62,1647,0,4,58,62,23,62
1358,P2SolutionsGroup,125,2514,0,9,116,125,39,125
1359,PacificControls,41,669,0,2,39,41,10,41
1360,Pactera,61,1371,0,3,58,61,23,61
1361,PAJGPS,234,4808,0,13,221,234,78,234
1362,PaloAltoNetworks,117,2276,0,3,114,117,33,117
1363,Panasonic,108,2563,0,9,99,108,40,108
1364,Panduit,120,2351,0,4,116,120,38,120
1365,Paraimpu,32,526,0,2,30,32,18,32
1366,PariRobotics,21,481,0,0,21,21,10,21
1367,Particle,121,2314,0,8,113,121,45,121
1368,PassatInnovationsLLC,98,1949,0,5,93,98,34,98
1369,PassiveLogic,148,3437,0,8,140,148,57,148
1370,PassivSystems,119,2384,0,7,112,119,41,119
1371,PassKit,29,464,0,1,28,29,9,29
1372,PatriotTechnologies,40,775,0,3,37,40,14,40
1373,PCTEL,7,143,0,2,5,7,4,7
1374,Peak,193,5039,2,24,167,193,86,193
1375,Pegatron,43,842,0,3,40,43,15,43
1376,PelotonTechnology,13,217,0,0,13,13,1,13
1377,PENSEES,36,1212,0,0,36,36,12,36
1378,Pentamaster,34,865,0,1,33,34,18,34
1379,PeopleandTechnology,597,12032,0,10,587,597,292,597
1380,PepperlFuchs,55,956,0,3,52,55,21,55
1381,Percent,53,1127,0,0,53,53,33,53
1382,Percepto,56,998,0,1,55,56,14,56
1383,PeregrineSemiconductor,202,3984,0,8,194,202,69,202
1384,PerfectionGeeksTechnologies,46,635,0,1,45,46,8,46
1385,PerfectPatternGmbH,33,426,0,0,33,33,5,33
1386,Periscube,52,926,0,0,52,52,20,52
1387,Pesslinstruments,98,2244,0,11,87,98,37,98
1388,Petasense,17,329,0,0,17,17,4,17
1389,PharosProduction,111,2553,0,7,104,111,41,111
1390,Philips,228,5997,1,25,202,228,101,228
1391,PhoenixEnergyTechnologies,34,875,0,1,33,34,23,34
1392,PhoenixTechnologies,84,1882,0,12,72,84,42,84
1393,Photoneo,51,986,0,8,43,51,24,51
1394,Phunware,137,3640,0,7,130,137,53,137
1395,PickleRobots,70,1504,0,6,64,70,25,70
1396,Pierbridge,31,602,0,0,31,31,8,31
1397,piezosystemjena,180,3088,0,7,173,180,59,180
1398,PINpointInformationSystemsInc,16,283,0,0,16,16,3,16
1399,PitneyBowes,140,3190,0,4,136,140,54,140
1400,PixelCrayons,22,309,0,1,21,22,5,22
1401,PixelPlex,101,1892,0,6,95,101,27,101
1402,Pixeom,38,934,0,0,38,38,19,38
1403,PixusTechnologies,125,2928,0,7,118,125,46,125
1404,PlaceIQ,93,1944,0,3,90,93,28,93
1405,Planet,110,2555,0,8,102,110,41,110
1406,PlanysTechnologies,19,303,0,0,19,19,7,19
1407,PlatformIO,39,681,0,1,38,39,16,39
1408,PlatHome,103,2180,0,6,97,103,33,103
1409,PLDA,49,1036,0,2,47,49,13,49
1410,PlexSystems,191,4459,0,20,171,191,84,191
1411,Plumis,130,3373,0,10,120,130,55,130
1412,Plusai,44,857,0,4,40,44,13,44
1413,PlusOneRobotics,93,1408,0,4,89,93,26,93
1414,PNYTechnologies,17,366,0,0,17,17,8,17
1415,PodGroupTrimble,87,1680,0,0,87,87,25,87
1416,PolluxAutomation,31,521,0,2,29,31,18,31
1417,Polte,81,1782,0,4,77,81,36,81
1418,Polynetworks,53,719,0,0,53,53,11,53
1419,Portcast,137,2056,0,3,134,137,42,137
1420,Posital,25,568,0,2,23,25,10,25
1421,POSSoftwareDevelopmentCompanyiVerveInc,11,103,0,0,11,11,1,11
1422,Pradotec,36,578,0,1,35,36,10,36
1423,Prafly,50,1110,0,6,44,50,29,50
1424,Predicta4,60,930,0,5,55,60,18,60
1425,PreferredNetworks,28,685,0,1,27,28,15,28
1426,PreformedLineProducts,70,1252,0,0,70,70,14,70
1427,Premio,26,564,0,5,21,26,16,26
1428,Prescient,33,601,0,0,33,33,9,33
1429,Presenso,89,1742,0,3,86,89,29,89
1430,Pressac,92,1813,0,4,88,92,33,92
1431,PressacCommunications,92,1813,0,4,88,92,33,92
1432,Preteckt,17,250,0,0,17,17,6,17
1433,Primeton,43,955,0,0,43,43,17,43
1434,Princeps,11,245,0,0,11,11,5,11
1435,PrismlabChina,78,1399,0,6,72,78,22,78
1436,PROCAD,41,717,0,2,39,41,16,41
1437,ProceraNetworks,112,2907,0,9,103,112,43,112
1438,ProcessPro,68,1282,0,7,61,68,28,68
1439,Prodapt,121,2376,0,4,117,121,36,121
1440,Prodrone,24,412,0,1,23,24,5,24
1441,Prodsmart,140,3194,0,5,135,140,46,140
1442,ProfessionalSystemsAssociates,38,754,0,3,35,38,13,38
1443,ProfitKeyInternational,73,1454,0,2,71,73,18,73
1444,Progress,162,4011,0,12,150,162,69,162
1445,ProjectFrog,61,1054,0,6,55,61,23,61
1446,ProLeiT,235,4556,0,14,221,235,84,235
1447,Promisense,3,27,0,0,3,3,0,3
1448,PROMISETechnology,35,752,0,4,31,35,17,35
1449,PropelApps,34,711,0,1,33,34,11,34
1450,Prophesee,4,63,0,0,4,4,1,4
1451,ProphetStorDataServices,112,2620,0,11,101,112,44,112
1452,PROSTEP,61,1385,0,4,57,61,21,61
1453,Protech,41,770,0,4,37,41,13,41
1454,ProtechSystems,41,698,0,4,37,41,13,41
1455,PrysmianGroup,45,1196,0,1,44,45,18,45
1456,PSA,83,1931,0,7,76,83,36,83
1457,PTC,56,1457,0,5,51,56,22,56
1458,PubNub,38,712,0,0,38,38,12,38
1459,PureHMXylem,67,1686,0,13,54,67,38,67
1460,QAD,63,1434,0,3,60,63,30,63
1461,QBurst,13,173,0,0,13,13,7,13
1462,QinhuangdaoIntrinsicCrystalTechnologyCoLtd,31,777,0,0,31,31,5,31
1463,QiOTechnologies,87,1613,0,2,85,87,32,87
1464,QLIKTAGSoftware,39,660,0,3,36,39,14,39
1465,QNAPSystems,179,3530,0,11,168,179,59,179
1466,QNXSoftwareSystems,2,46,0,0,2,2,1,2
1467,Qorvo,114,1184,0,2,112,114,19,114
1468,Qosmos,49,844,0,1,48,49,22,49
1469,QsanTechnology,8,131,0,1,7,8,3,8
1470,Qsee,2,22,0,0,2,2,2,2
1471,Qt,49,1037,0,5,44,49,25,49
1472,QuakeGlobal,25,552,0,4,21,25,7,25
1473,QuantaComputer,25,462,0,2,23,25,6,25
1474,QuantService,7,172,0,0,7,7,4,7
1475,QueclinkWirelessSolutions,65,1313,0,3,62,65,18,65
1476,Quectel,128,2631,0,7,121,128,33,128
1477,Questglt,29,406,1,0,28,29,7,29
1478,Quincus,44,1206,0,4,40,44,21,44
1479,QulixSystems,93,1677,0,1,92,93,35,93
1480,QultAI,83,1750,0,3,80,83,24,83
1481,RADCOM,71,1676,0,3,68,71,24,71
1482,RADDataCommunications,75,1529,0,1,74,75,14,75
1483,Radiall,22,354,0,2,20,22,10,22
1484,Radientum,38,826,0,0,38,38,19,38
1485,Radiflow,23,420,0,2,21,23,7,23
1486,RadioBridge,92,2562,0,0,92,92,25,92
1487,RadioFrequencySystemsRFS,93,2049,0,7,86,93,37,93
1488,Radisys,106,2158,0,10,96,106,43,106
1489,RadleyCorporation,44,1088,0,2,42,44,15,44
1490,RAFI,70,1341,0,5,65,70,28,70
1491,Raima,27,449,0,2,25,27,7,27
1492,RainBirdCorporation,148,3086,0,8,140,148,47,148
1493,RamcoSystems,95,2101,0,11,84,95,36,95
1494,RancherLabs,45,808,0,1,44,45,11,45
1495,Rapid7,5,28,0,0,5,5,0,5
1496,RapidValueAspireSystems,10,170,0,0,10,10,0,10
1497,ReachTech,80,1372,0,2,78,80,22,80
1498,READYRobotics,52,1254,0,2,50,52,20,52
1499,RealityAI,127,2606,0,5,122,127,46,127
1500,RealTimeInnovations,86,1518,0,6,80,86,28,86
1501,RealTimeLogic,66,1206,0,2,64,66,18,66
1502,RealtimeRobotics,96,2046,0,4,92,96,36,96
1503,RealTimeSystems,64,1149,0,4,60,64,27,64
1504,RECT,85,1822,0,8,77,85,30,85
1505,RecursionPharmaceuticals,9,114,0,0,9,9,0,9
1506,REDALERTLABS,7,92,0,0,7,7,1,7
1507,Redaptive,113,2337,0,4,109,113,33,113
1508,RedDotAnalytics,125,2175,0,2,123,125,37,125
1509,RedHat,176,4445,0,18,158,176,64,176
1510,RedlineCommunications,131,2758,0,0,131,131,57,131
1511,RedpineSignals,17,300,0,0,17,17,6,17
1512,RedSalt,105,2592,0,2,103,105,43,105
1513,reed,36,734,0,5,31,36,11,36
1514,Reekoh,95,1550,0,3,92,95,27,95
1515,RefractionAI,25,518,0,0,25,25,12,25
1516,RejigDigital,60,1362,0,2,58,60,20,60
1517,relayr,114,2835,0,3,111,114,49,114
1518,ReliaSoftware,29,716,0,0,29,29,10,29
1519,Relimetrics,75,2006,0,12,63,75,41,75
1520,RELOCsrl,21,466,0,1,20,21,5,21
1521,remoteit,204,4073,0,4,200,204,74,204
1522,ReplicableTechnologies,64,1345,0,0,64,64,22,64
1523,ResurfaceLabs,48,848,0,1,47,48,12,48
1524,Resync,47,1068,0,2,45,47,12,47
1525,RethinkRobotics,242,4672,0,11,231,242,90,242
1526,Revenera,45,855,0,1,44,45,14,45
1527,Reversio,59,1235,0,1,58,59,19,59
1528,Revinfotech,110,2576,0,11,99,110,52,110
1529,RewireSecurity,136,2403,0,7,129,136,55,136
1530,RexrothBosch,305,6127,0,13,292,305,86,305
1531,RFCode,29,705,0,1,28,29,14,29
1532,RhombusEnergySolutionsInc,9,91,0,0,9,9,1,9
1533,RibbonCommunications,198,4689,0,28,170,198,102,198
1534,RicohCompanyLtd,1,6,0,0,1,1,0,1
1535,Rinkak,29,410,0,1,28,29,8,29
1536,RIOT,230,6030,0,16,214,230,84,230
1537,RipplesIOT,62,1395,0,5,57,62,26,62
1538,RISEYE,78,1950,0,9,69,78,36,78
1539,Rittal,115,2667,0,7,108,115,49,115
1540,Riven,71,1536,0,2,69,71,23,71
1541,Rivetz,18,303,0,1,17,18,9,18
1542,RMUS,32,818,0,2,30,32,16,32
1543,RoadMapITSolutions,11,165,0,1,10,11,3,11
1544,ROAMROBOTICS,81,1647,0,10,71,81,27,81
1545,RoboCV,137,3498,0,14,123,137,62,137
1546,RoboDK,33,628,0,3,30,33,21,33
1547,RobolabTechnologiesPvtLtd,48,883,0,5,43,48,14,48
1548,RoboticMaterials,137,3498,0,14,123,137,62,137
1549,Robustel,4,56,0,0,4,4,1,4
1550,RockwellAutomation,124,2816,0,5,119,124,40,124
1551,ROHMCoLtd,2,62,0,0,2,2,1,2
1552,Roima,106,2331,0,2,104,106,44,106
1553,Rokid,1,3,0,0,1,1,0,1
1554,Rombit,44,982,0,7,37,44,22,44
1555,RootstockSoftware,196,4356,0,4,192,196,51,196
1556,ROSCH,68,1549,0,6,62,68,26,68
1557,Rostelecom,62,1211,0,5,57,62,23,62
1558,Rotork,83,1457,0,2,81,83,30,83
1559,Rovisys,40,783,1,2,37,40,15,40
1560,Royal4Systems,32,467,0,1,31,32,7,32
1561,RSADELLDellTechnologies,59,885,0,3,56,59,10,59
1562,RSMonition,52,998,0,3,49,52,23,52
1563,RSTAHL,93,1884,0,7,86,93,39,93
1564,RTI,72,1384,0,1,71,72,32,72
1565,RtTechSoftware,28,431,0,0,28,28,6,28
1566,RubiconGlobal,130,3038,0,13,117,130,49,130
1567,Ruff,163,3328,0,6,157,163,53,163
1568,RufusLabs,65,1269,0,3,62,65,22,65
1569,ruhlamat,24,335,0,0,24,24,5,24
1570,Rulex,21,303,0,0,21,21,7,21
1571,RVAutomationTechnologyCo,69,1062,0,3,66,69,21,69
1572,S3ID,45,848,0,2,43,45,15,45
1573,SADELABS,3,76,0,1,2,3,2,3
1574,SafeMode,37,562,0,3,34,37,18,37
1575,Sagemcom,84,1701,0,5,79,84,34,84
1576,Saildrone,50,993,0,3,47,50,21,50
1577,SALTSoftware,93,2255,0,9,84,93,32,93
1578,SamayGlobal,107,2348,0,4,103,107,45,107
1579,SampCElectricCompany,190,4951,0,13,177,190,79,190
1580,SampTGroup,41,578,0,1,40,41,13,41
1581,Samsara,71,1634,0,2,69,71,22,71
1582,SamsungElectronics,108,2161,0,7,101,108,36,108
1583,SamsungSemiconductorIncSSISamsungElectronics,138,2317,0,11,127,138,42,138
1584,SankenElectric,45,904,0,7,38,45,20,45
1585,SAP,171,4143,0,22,149,171,70,171
1586,Sapiens,33,532,0,0,33,33,10,33
1587,Satalia,65,1142,0,7,58,65,28,65
1588,SaudiTelecomCompanySolutions,41,841,0,0,41,41,9,41
1589,Saviant,30,505,0,2,28,30,9,30
1590,SBSScienceampTechnology,102,1848,0,2,100,102,34,102
1591,SCADACore,14,300,0,0,14,14,2,14
1592,ScaleFocus,150,3764,0,16,134,150,60,150
1593,ScarletTechnologies,16,280,0,1,15,16,2,16
1594,SchindlerAhead,216,4758,0,10,206,216,96,215
1595,Schlumberger,75,1735,0,4,71,75,32,75
1596,SchneiderElectric,23,343,0,0,23,23,5,23
1597,Schurter,63,1298,0,4,59,63,22,63
1598,ScientificGreen,201,4374,0,11,190,201,72,201
1599,Sciyon,4,116,0,0,4,4,0,4
1600,Scortex,66,1592,0,4,62,66,30,66
1601,SDChain,13,303,0,0,13,13,7,13
1602,Seatone,35,683,0,2,33,35,17,35
1603,SECO,29,628,0,0,29,29,10,29
1604,SECOEnergy,25,500,0,3,22,25,15,25
1605,Secomea,82,1708,0,7,75,82,38,82
1606,SecureMeters,14,308,0,0,14,14,8,14
1607,SedaptaOsys,7,50,0,0,7,7,1,7
1608,SedinTechnologies,13,259,0,0,13,13,3,13
1609,Seebo,115,2146,1,4,110,115,30,115
1610,Seeq,51,929,0,7,44,51,26,51
1611,Seisys,93,1772,0,5,88,93,27,93
1612,Seluxit,97,2050,0,6,91,97,40,97
1613,SemicoaSemiconductors,136,3305,0,8,128,136,55,136
1614,SemiDotInfotech,68,1188,0,1,67,68,17,68
1615,SemioticLabs,38,578,0,3,35,38,19,38
1616,Semtech,161,3927,0,9,152,161,75,161
1617,Seneca,84,1835,0,6,78,84,40,84
1618,Senet,70,1781,0,5,65,70,39,70
1619,SensacoGmbH,2,11,0,0,2,2,0,2
1620,SenSat,133,3411,0,9,124,133,60,133
1621,Sensavation,47,957,0,2,45,47,18,47
1622,Sensee,32,561,0,1,31,32,15,32
1623,SenseGrow,115,2585,0,7,108,115,32,115
1624,Sensetime,120,2484,0,9,111,120,43,120
1625,Sensewaves,5,120,0,0,5,5,1,5
1626,Senseye,70,1343,0,1,69,70,25,70
1627,SensirionAG,244,6822,0,6,238,244,111,244
1628,Sensolus,39,581,0,0,39,39,9,39
1629,Sensorbis,36,715,0,2,34,36,15,36
1630,Sensorla,142,2567,0,5,137,142,57,142
1631,SensorsData,68,1076,0,3,65,68,24,68
1632,SensorSuite,13,112,0,0,13,13,3,13
1633,SensorVtal,90,1794,0,4,86,90,32,90
1634,Sensr,17,319,0,0,17,17,2,17
1635,Sensry,174,4886,0,6,168,174,81,174
1636,Sentilo,35,1036,0,0,35,35,18,35
1637,SepioSystems,57,1505,0,11,46,57,36,57
1638,SequiturLabs,84,1554,0,4,80,84,29,84
1639,SeriousIntegrated,85,2149,0,4,81,85,45,85
1640,ServerTechnology,26,516,0,2,24,26,11,26
1641,SERVOROBOT,75,1600,0,6,69,75,34,75
1642,SERVOTRONIXMOTIONCONTROL,112,2198,0,11,101,112,40,112
1643,SeventhSense,116,2590,0,9,107,116,37,116
1644,Sevskiy,3,23,0,0,3,3,0,3
1645,ShadowCreator,58,1379,0,9,49,58,18,58
1646,Shaip,63,1202,0,3,60,63,26,63
1647,ShalakaTechnologies,49,1086,0,3,46,49,15,48
1648,ShanghaiLinxValleySystem,39,654,0,1,38,39,17,39
1649,ShanghaiSmartStateTechnology,2,38,0,1,1,2,1,2
1650,ShanghaiSunrayInformationTechnology,93,1653,0,4,89,93,24,93
1651,ShanghaiWitiumInformationTechnologyCoLtd,12,236,0,0,12,12,2,12
1652,Shengfeng,74,1703,1,9,64,74,32,74
1653,ShenzhenAerospaceInnotechCorporation,54,1091,0,1,53,54,12,54
1654,ShenzhenHuayangXinkeElectronicsCoLtd,12,158,0,1,11,12,3,12
1655,ShenzhenLigentSensorTech,3,41,0,0,3,3,0,3
1656,Sherpa,194,4044,0,6,188,194,86,194
1657,ShieldIoT,95,2305,0,5,90,95,28,95
1658,shipcloudio,217,4149,0,16,201,217,74,217
1659,Shippeo,25,565,0,1,24,25,13,25
1660,Shipwell,154,3162,0,14,140,154,49,154
1661,ShopEdgeSoftware,52,1167,0,2,50,52,20,52
1662,ShoptechSoftware,51,999,0,4,47,51,20,51
1663,SiboTechAutomation,67,1379,0,8,59,67,28,67
1664,Siemens,96,2418,0,7,89,96,35,96
1665,SiemensAdvanta,56,1094,0,4,52,56,18,56
1666,SierraWireless,164,3227,0,11,153,164,61,164
1667,Sigband,164,4446,0,11,153,164,78,164
1668,SigFox,97,1570,0,3,94,97,11,97
1669,SightlineSystems,89,2138,0,10,79,89,49,89
1670,SignalCruncher,88,1433,0,3,85,88,30,88
1671,SignalGarden,43,898,1,5,37,43,14,43
1672,SignalIntegritySoftware,68,1343,0,6,62,68,22,68
1673,Signalogic,3,19,0,0,3,3,0,3
1674,SignalSciences,145,3492,0,15,130,145,63,145
1675,SignitySolutions,36,599,0,0,36,36,13,36
1676,SilentSensors,64,1328,0,3,61,64,19,64
1677,SilexTechnologyAmerica,39,938,0,5,34,39,18,39
1678,Siliconfile,3,31,0,1,2,3,1,3
1679,SiliconLabs,118,2805,0,3,115,118,40,118
1680,SiliconMotionTechnology,46,1425,0,3,43,46,20,46
1681,SilverPeakSystems,156,3308,0,7,149,156,55,156
1682,SimbeRobotics,23,576,0,3,20,23,15,23
1683,SIMComWirelessSolutions,80,1533,0,7,73,80,26,80
1684,Simevo,9,82,0,0,9,9,1,9
1685,Simform,23,475,0,0,23,23,11,23
1686,SimocoWirelessSolutions,36,773,0,1,35,36,16,36
1687,SimpleHardware,18,369,0,1,17,18,6,18
1688,SimpleSoft,13,181,0,0,13,13,3,13
1689,Simplifier,209,4346,0,10,199,209,69,209
1690,SIMTechnology,40,538,0,2,38,40,16,40
1691,Simularity,129,2698,0,13,116,129,54,129
1692,Sinch,120,2964,0,4,116,120,48,120
1693,Singularities,248,5511,0,14,234,248,117,248
1694,SINTEF,20,271,0,0,20,20,7,20
1695,SintronesTechnologyCorp,42,836,0,2,40,42,13,42
1696,SirqulInc,84,2066,0,9,75,84,32,84
1697,SixAI,40,824,0,4,36,40,11,40
1698,SixSq,35,467,0,4,31,35,9,35
1699,SixthEnergyTechnologiesPrivateLimited,50,893,0,2,48,50,18,50
1700,SketchUp,157,2614,0,19,138,157,53,157
1701,Skkynet,104,2490,0,10,94,104,46,104
1702,SKSKontakttechnik,77,1432,0,3,74,77,19,77
1703,Skyhook,132,3342,0,10,122,132,52,132
1704,SkyPuzzle,11,122,0,0,11,11,2,11
1705,Slamtec,4,49,0,0,4,4,0,4
1706,SLASCONE,135,2816,0,16,119,135,55,135
1707,SLNSolutionsLLC,57,937,0,4,53,57,22,57
1708,Slyncio,51,770,0,3,48,51,18,51
1709,SmartEAM,28,398,0,2,26,28,11,28
1710,SmartenSpaces,25,509,0,2,23,25,7,25
1711,SmarterSorting,63,1449,0,5,58,63,26,63
1712,smartFAB,53,869,0,1,52,53,12,53
1713,SmartFactory,31,667,0,3,28,31,15,31
1714,SmartSensedoo,48,883,0,2,46,48,16,48
1715,SmartSystemsHub,92,1889,0,2,90,92,32,92
1716,SmartTouchSystemsO,34,697,0,2,32,34,11,34
1717,SMARTWirelessComputing,13,174,0,0,13,13,3,13
1718,Sngular,86,1791,0,1,85,86,26,86
1719,SoCeSystemonChipEngineering,7,93,0,0,7,7,0,7
1720,Sodacar,167,3307,0,17,150,167,50,167
1721,SoftChef,40,739,0,2,38,40,15,40
1722,SoftDEL,57,1493,0,5,52,57,23,57
1723,Softdesigners,54,1523,0,5,49,54,23,54
1724,Softeq,85,1946,0,5,80,85,43,85
1725,Softing,230,4072,0,13,217,230,66,230
1726,Softlink,103,1824,0,5,98,103,25,103
1727,Softnautics,25,361,0,0,25,25,7,25
1728,SoftwareAG,117,2082,0,7,110,117,45,117
1729,SOLCON,169,3408,0,11,158,169,55,169
1730,SolePower,35,740,0,5,30,35,14,35
1731,SolidPartners,36,654,0,1,35,36,12,36
1732,SolidRun,65,995,0,4,61,65,15,65
1733,Soloinsight,50,1160,0,2,48,50,16,50
1734,SoluLab,22,355,0,1,21,22,6,22
1735,SoluLabOfficial,22,355,0,1,21,22,6,22
1736,SolutionAnalysts,47,1119,0,0,47,47,18,47
1737,SOLX,63,1448,0,4,59,63,19,63
1738,Sony,83,2186,0,5,78,83,41,83
1739,SonySemiconductorIsraelSony,59,968,0,2,57,59,12,59
1740,Sophos,129,3873,0,14,115,129,60,129
1741,SORBAIoT,35,773,0,3,32,35,20,35
1742,SOSLab,77,1489,0,4,73,77,18,77
1743,SpaceAgeLabs,52,929,0,2,50,52,20,52
1744,SparkCognition,92,2002,0,2,90,92,33,92
1745,SPARKL,56,1207,0,3,53,56,22,56
1746,SparksDynamics,135,3681,0,9,126,135,65,135
1747,SparxITSolutions,76,1268,0,2,74,76,24,76
1748,spdukraine,113,2423,0,7,106,113,34,113
1749,SPECINDIA,45,820,0,1,44,45,11,45
1750,SpectrumControls,44,858,0,3,41,44,24,44
1751,SpeedshieldTechnologies,70,1725,0,6,64,70,32,70
1752,Spensa,33,612,0,0,33,33,14,33
1753,Spify,105,1712,0,9,96,105,32,105
1754,SpimeSenseLabs,29,510,0,1,28,29,8,29
1755,SpindernetITSolutions,9,74,0,0,9,9,1,9
1756,SpinwaveSystems,4,28,0,1,3,4,1,4
1757,SpiraeLLC,80,1568,0,7,73,80,30,80
1758,Splunk,147,2813,0,7,140,147,46,147
1759,sposync,37,602,0,0,37,37,15,37
1760,SpotnRides,33,532,0,2,31,33,9,33
1761,SpotnStay,25,417,0,0,25,25,8,25
1762,Sprint,191,3493,0,11,180,191,62,190
1763,SPSamson,136,2704,0,8,128,136,43,136
1764,SSTCOMM,23,484,0,1,22,23,14,23
1765,SSTWireless,36,862,0,1,35,36,12,36
1766,StandardRobots,297,6368,0,12,285,297,134,297
1767,StanleyHealthcare,46,935,0,0,46,46,19,46
1768,Star,87,1604,0,1,86,87,22,87
1769,Starhub,49,872,0,2,47,49,19,49
1770,StarshipTechnologies,103,1859,0,4,99,103,36,103
1771,Statwig,31,484,0,0,31,31,11,31
1772,SteamaCo,25,532,0,1,24,25,10,25
1773,STEngineering,6,137,0,1,5,6,2,6
1774,Sternum,77,2176,0,4,73,77,36,77
1775,STMicroelectronics,13,212,0,1,12,13,5,13
1776,Stratoscale,40,644,0,0,40,40,16,40
1777,Striim,112,2523,0,6,106,112,35,112
1778,Stubli,44,806,0,0,44,44,11,44
1779,Sturfee,2,42,0,0,2,2,1,2
1780,Subex,249,5179,0,8,241,249,89,249
1781,SubexSecure,249,5179,0,8,241,249,89,249
1782,Sucheon,21,280,0,1,20,21,9,21
1783,SumeruVerdeTechnologies,80,1655,0,1,79,80,25,80
1784,SuntekAutomation,53,933,0,0,53,53,21,53
1785,SUPCONGroup,2,8,0,0,2,2,1,2
1786,Supermicro,166,3373,0,10,156,166,49,166
1787,SuperRFID,14,141,0,0,14,14,3,14
1788,SupplyDynamics,47,705,0,0,47,47,11,47
1789,SupplyShift,35,929,0,1,34,35,12,35
1790,SupplyStack,54,1122,0,4,50,54,21,54
1791,SurePark,87,1967,0,1,86,87,33,87
1792,SureViewInstrumentsIndia,140,3013,0,2,138,140,40,140
1793,SUSE,161,3309,0,19,142,161,61,161
1794,Swimai,199,4973,0,19,180,199,87,199
1795,Swissbit,148,3709,0,4,144,148,64,148
1796,SwitchAutomation,86,1587,0,7,79,86,35,86
1797,Switchon,77,1640,0,4,73,77,28,77
1798,Swrve,76,1808,0,6,70,76,31,76
1799,Sycor,65,1285,1,3,61,65,22,65
1800,SymbioRobotics,56,1196,0,1,55,56,21,56
1801,SynapIoT,20,234,0,1,19,20,5,20
1802,SynapseWireless,33,731,0,4,29,33,18,33
1803,Synaptics,84,2026,0,5,79,84,34,84
1804,SynergisSoftware,126,2593,0,10,116,126,50,126
1805,SynSense,110,2416,0,10,100,110,39,110
1806,SyntecTechnology,73,1486,0,3,70,73,25,73
1807,Sysmex,106,2629,0,8,98,106,45,106
1808,SYSPRO,47,1281,0,5,42,47,22,47
1809,SYSTEMAGmbH,120,2509,0,5,115,120,42,120
1810,Tableau,47,962,0,3,44,47,23,47
1811,Tachyus,78,1700,0,9,69,78,32,78
1812,TAGOptics,23,438,0,0,23,23,4,23
1813,TAIAN,52,938,0,0,52,52,20,52
1814,TaiwanSemiconductor,95,2528,0,4,91,95,30,95
1815,TaiwanSemiconductorManufacturingCompanyLtdTSMC,95,2528,0,4,91,95,30,95
1816,TaiyoYuden,169,4724,0,6,163,169,81,169
1817,Talentcloud,10,161,0,0,10,10,2,10
1818,TargetNXT,56,1079,0,2,54,56,16,56
1819,TASM2M,72,1252,0,0,72,72,9,72
1820,TataCommunications,149,4234,0,9,140,149,59,149
1821,TataConsultancyServices,74,1864,0,8,66,74,33,74
1822,TataConsultingEngineersLimited,73,1620,2,1,70,73,24,73
1823,TDInsights,83,1129,0,3,80,83,22,83
1824,TDTechNokiaampHuawei,113,2220,0,12,101,113,48,113
1825,TeamViewer,39,742,0,0,39,39,21,39
1826,TechAvidus,68,995,0,0,68,68,15,68
1827,TechExcel,81,1699,0,1,80,81,27,81
1828,TechMahindra,69,1565,0,9,60,69,30,69
1829,TechmanRobotInc,25,375,0,1,24,25,10,25
1830,technicolor,91,1656,0,8,83,91,32,91
1831,TechnosphereLabs,14,249,0,0,14,14,2,14
1832,Technoton,26,443,0,2,24,26,12,26
1833,TechnotonEngineering,28,490,0,2,26,28,12,28
1834,Technource,32,363,0,0,32,32,9,32
1835,Tecnologic,597,12032,0,10,587,597,292,597
1836,TeDaLoS,49,868,0,0,49,49,16,49
1837,Teeptrak,50,832,0,1,49,50,13,50
1838,TekelekGroup,68,1080,0,1,67,68,22,68
1839,TeksunInc,43,593,0,1,42,43,8,43
1840,TELE2,60,1167,0,1,59,60,25,60
1841,TeledyneTechnologies,48,966,0,1,47,48,11,48
1842,Telefonica,54,1441,0,1,53,54,22,54
1843,Telensa,94,1797,0,3,91,94,32,94
1844,TeleSourceCommunications,44,953,0,0,44,44,19,44
1845,Telezone,24,355,0,1,23,24,6,24
1846,Telia,38,693,0,0,38,38,13,38
1847,TelicAG,44,1059,0,2,42,44,17,44
1848,Telkonet,22,349,0,2,20,22,6,22
1849,Tellabs,86,1604,0,23,63,86,50,86
1850,Telstra,166,3078,0,3,163,166,37,166
1851,Teltonika,81,1845,0,6,75,81,28,81
1852,TeltonikaCanada,81,1845,0,6,75,81,28,81
1853,Temboo,71,1485,0,4,67,71,17,71
1854,Tempestive,82,1774,0,2,80,82,25,82
1855,TempGenius,213,5281,1,21,191,213,94,213
1856,TempoAutomation,35,617,0,1,34,35,7,35
1857,Tenable,188,3808,0,7,181,188,62,188
1858,TenAsys,35,665,0,4,31,35,19,35
1859,TencentCloud,220,4754,0,2,218,220,64,220
1860,Tendai,145,3808,0,22,123,145,64,145
1861,TeraCode,57,917,0,2,55,57,16,57
1862,Teradata,16,318,0,0,16,16,3,16
1863,Teraki,69,1203,0,2,67,69,20,69
1864,TerasicTechnologies,41,618,0,1,40,41,12,41
1865,Terbine,77,1925,0,5,72,77,33,77
1866,Terepac,43,1033,0,0,43,43,17,43
1867,TetraScience,66,1426,0,5,61,66,22,66
1868,Thales,26,523,0,2,24,26,10,26
1869,ThalesGroup,26,523,0,2,24,26,10,26
1870,TheHiTechRoboticSystemz,17,389,0,2,15,17,10,17
1871,TheJaiGroup,51,1052,0,5,46,51,19,51
1872,ThetaRay,108,2433,0,17,91,108,51,108
1873,thethingsio,192,5414,0,11,181,192,100,192
1874,thethingsystem,27,534,0,1,26,27,7,27
1875,ThinfilmElectronicsASA,60,970,0,2,58,60,16,60
1876,Thing,36,647,0,1,35,36,10,36
1877,Thingerio,38,677,0,1,37,38,15,38
1878,ThingLogix,57,1347,0,5,52,57,20,57
1879,ThingsBoard,47,841,0,0,47,47,19,47
1880,Thingspeak,37,536,0,2,35,37,12,37
1881,Thingsquare,39,534,0,5,34,39,11,39
1882,Thingstel,104,2228,0,3,101,104,42,104
1883,ThingTech,4,41,0,0,4,4,0,4
1884,ThingTrax,68,1206,0,0,68,68,22,68
1885,Thingworks,56,1457,0,5,51,56,22,56
1886,ThingWorxPTC,56,1457,0,5,51,56,22,56
1887,ThinkPalmTechnologiesPvtLtd,29,623,0,3,26,29,15,29
1888,ThoughtSpot,104,2100,0,4,100,104,28,104
1889,ThoughtWorks,213,4105,0,15,198,213,80,213
1890,ThreeBIT,104,2275,0,3,101,104,33,104
1891,Thyssenkrupp,93,1942,0,4,89,93,30,93
1892,TianchenElectric,27,683,0,2,25,27,10,27
1893,TibboSystems,40,834,0,4,36,40,16,40
1894,TIBCOSoftware,146,2990,1,5,140,146,52,146
1895,Tiertime,79,1827,0,6,73,79,38,79
1896,Tieto,125,2783,0,2,123,125,53,125
1897,Timescale,193,4626,0,14,179,193,70,193
1898,TMobileDeutscheTelekom,3,28,0,1,2,3,1,3
1899,TOAElectronicsInc,51,1021,0,5,46,51,14,51
1900,Tobii,152,3102,0,14,138,152,43,152
1901,TokyoElectronDeviceLtd,26,710,1,1,24,26,12,26
1902,TongfangCloudComputingTechnology,8,122,0,0,8,8,2,8
1903,TopConnect,106,2465,0,7,99,106,40,106
1904,TopperFloatingSolarPVMountingManufacturerCoLtd,9,95,0,0,9,9,2,9
1905,Topsec,78,1591,0,7,71,78,27,78
1906,Toradex,111,2331,0,6,105,111,29,111
1907,Toshiba,42,980,0,3,39,42,17,42
1908,TOSHIKCON,37,552,0,3,34,37,18,37
1909,TotalETO,65,1392,0,4,61,65,22,65
1910,ToyotaMaterialHandlingEurope,85,1694,0,7,78,85,28,85
1911,TQSystems,15,224,0,0,15,15,5,15
1912,TranscendCommunication,130,3660,0,7,123,130,58,130
1913,TransitionNetworks,117,2140,0,2,115,117,30,117
1914,TransitionTechnologies,32,654,0,2,30,32,14,32
1915,TransVoyant,105,2306,0,2,103,105,38,105
1916,Traverse,107,2708,0,10,97,107,42,107
1917,TrendMicro,11,145,0,0,11,11,3,11
1918,TrendMiner,92,2113,0,6,86,92,33,92
1919,TridiumHoneywell,107,2700,0,7,100,107,29,107
1920,TrilliumIncorporated,30,658,0,3,27,30,13,30
1921,TrippLite,93,1772,0,5,88,93,27,93
1922,Trumpf,307,5161,0,10,297,307,101,307
1923,TSystemsDeutscheTelekom,113,2445,0,6,107,113,45,113
1924,TulipInterfaces,199,4541,0,24,175,199,88,199
1925,Turck,39,784,0,4,35,39,12,39
1926,TuringRobot,136,2952,0,3,133,136,50,136
1927,Turnsmith,41,891,0,2,39,41,14,41
1928,TuSimple,109,2201,0,5,104,109,31,109
1929,TVInformationstechnikGmbH,159,3337,0,8,151,159,60,159
1930,Twikit,52,1348,0,0,52,52,13,52
1931,Twilio,349,7949,0,37,312,349,155,349
1932,TwinOaksComputing,60,1221,0,2,58,60,19,60
1933,Twixsoft,30,525,0,1,29,30,14,30
1934,Uavia,33,547,0,1,32,33,12,33
1935,uBeac,53,1061,0,3,50,53,17,53
1936,Ubidots,54,1387,0,3,51,54,26,54
1937,Ubiik,85,1753,0,2,83,85,26,85
1938,Ubuntu,150,2738,1,7,142,150,45,150
1939,UCloud,90,1784,1,3,86,90,28,90
1940,Udhyog40LLP,6,21,0,0,6,6,0,6
1941,Uffizio,66,1305,0,3,63,66,21,66
1942,UgMOTechnologies,8,118,0,1,7,8,3,8
1943,UL,81,1538,0,1,80,81,19,81
1944,ulalaLAB,68,1494,0,6,62,68,23,68
1945,UMEInfo,53,1093,0,4,49,53,22,53
1946,UnaBiz,86,1508,0,3,83,86,11,86
1947,UNICOMEngineering,81,1465,0,3,78,81,26,81
1948,Unifly,208,4172,0,11,197,208,72,208
1949,Unioncrate,23,395,0,0,23,23,10,23
1950,Unisys,108,2414,0,9,99,108,39,108
1951,UnitedElectronicIndustries,49,964,1,4,44,49,15,49
1952,UNITYConsulting,95,1719,0,5,90,95,34,95
1953,UniversalScientificIndustrial,36,1169,0,5,31,36,15,36
1954,UniviewChinaTransinfo,97,2427,1,7,89,97,52,97
1955,Upskill,119,2350,0,12,107,119,51,119
1956,UpSwift,80,1731,0,5,75,80,34,80
1957,Uptake,90,1788,0,2,88,90,21,90
1958,URBANTZ,68,1749,0,8,60,68,31,68
1959,Urbint,140,2697,0,10,130,140,44,140
1960,Urbiotica,10,289,0,1,9,10,4,10
1961,UrsalinkTechnology,66,1503,0,4,62,66,22,66
1962,USATechnologies,54,956,0,0,54,54,20,54
1963,UTILEV,74,1805,0,6,68,74,31,74
1964,utthunga,34,826,0,1,33,34,16,34
1965,UtthungaTechnologies,34,826,0,1,33,34,16,34
1966,UTTTechnologies,29,427,0,1,28,29,13,29
1967,V2COM,62,1305,0,2,60,62,18,62
1968,VadaTech,28,513,0,1,27,28,7,28
1969,Vaisto,24,371,0,4,20,24,11,24
1970,Valarm,95,2215,0,6,89,95,36,95
1971,Variantz,141,3096,0,12,129,141,47,141
1972,Variscite,23,455,0,0,23,23,4,23
1973,VARJO,60,1395,0,3,57,60,22,60
1974,VDOO,52,1003,0,6,46,52,19,52
1975,Vechain,120,2814,0,5,115,120,52,120
1976,Vector,160,3271,0,12,148,160,61,160
1977,VegamSolutions,8,137,0,0,8,8,3,8
1978,Velocio,67,1191,0,4,63,67,20,67
1979,VentureTechnologies,27,521,0,2,25,27,11,27
1980,VeoRobotics,24,498,0,0,24,24,12,24
1981,VerdigrisTechnologies,53,1046,0,3,50,53,15,53
1982,VeridifySecurity,79,2293,0,8,71,79,44,79
1983,Verimatrix,174,3548,0,9,165,174,61,174
1984,VersaFleet,47,1123,0,4,43,47,24,47
1985,VersaLogic,85,2076,0,13,72,85,41,85
1986,Vertex,129,3160,0,5,124,129,32,129
1987,VGSmartGlass,50,1032,0,5,45,50,21,50
1988,ViaviSolutions,36,624,0,3,33,36,9,36
1989,Videas,76,1526,0,8,68,76,29,76
1990,Viezo,14,362,0,0,14,14,13,14
1991,VIGNANINSTRUMENTS,25,481,0,0,25,25,9,25
1992,VINCIDigital,96,1683,0,5,91,96,26,96
1993,Vinnter,21,357,0,1,20,21,6,21
1994,VionTech,34,551,0,1,33,34,7,34
1995,VirgilSecurity,7,119,0,0,7,7,0,7
1996,Vishay,194,3967,0,21,173,194,93,194
1997,VISIONERF,23,356,0,0,23,23,7,23
1998,VisionLabApps,68,1530,0,4,64,68,21,68
1999,VisionMC,59,1179,0,1,58,59,21,59
2000,VisualCommunicationsCompany,88,1962,0,5,83,88,29,88
2001,VitalConnect,46,848,0,1,45,46,20,46
2002,VitaNetInc,33,583,0,0,33,33,10,33
2003,VitroTechnologyCorporation,36,809,0,0,36,36,10,36
2004,ViTrox,15,326,0,1,14,15,5,15
2005,VividWorks,45,632,0,5,40,45,15,45
2006,VivifyHealth,125,3293,0,11,114,125,59,125
2007,Vizibl,90,1604,0,2,88,90,22,90
2008,VKS,41,789,0,0,41,41,17,41
2009,VMwareDELLDellTechnologies,59,885,0,3,56,59,10,59
2010,VOCSens,9,122,0,0,9,9,1,9
2011,Vodafone,136,1746,0,9,127,136,25,136
2012,Voith,80,1550,0,2,78,80,20,80
2013,Volansys,60,1057,0,1,59,60,18,60
2014,Volex,63,1595,0,3,60,63,17,63
2015,Volocopter,193,3102,0,13,180,193,62,193
2016,VoltaicSystems,45,1112,0,8,37,45,20,45
2017,Vopak,34,701,0,5,29,34,18,34
2018,Vultr,88,1778,0,3,85,88,24,88
2019,VUZIX,52,1128,0,1,51,52,19,52
2020,VVDNTECHNOLOGIES,66,1337,0,3,63,66,22,66
2021,W2SSolutions,29,503,0,4,25,29,9,29
2022,WABTEC,75,1965,0,3,72,75,27,75
2023,Wahtari,30,345,0,0,30,30,8,30
2024,WakeCapTechnologies,30,638,0,3,27,30,14,30
2025,Wandelbots,252,5394,0,11,241,252,90,252
2026,Wapice,51,660,0,3,48,51,13,51
2027,Wasslz,68,1304,0,3,65,68,27,68
2028,WatchNETIoT,71,1609,0,4,67,71,24,71
2029,WaterfallSecuritySolutionsLTD,45,1012,0,1,44,45,18,45
2030,WaterGroup,57,1126,1,4,52,57,23,57
2031,WaterlooSoftware,37,758,0,0,37,37,12,37
2032,Waterstream,95,2001,0,3,92,95,32,95
2033,WattIQ,43,849,0,3,40,43,11,43
2034,Wavetronix,396,7110,0,5,391,396,163,396
2035,WAVIoT,190,4757,0,8,182,190,73,189
2036,Waylay,110,2758,0,11,99,110,59,110
2037,WayRay,52,1091,0,3,49,52,22,52
2038,WeAlwinTechnologies,60,846,0,1,59,60,15,60
2039,WeAre,109,2009,1,2,106,109,37,109
2040,Webalo,74,1505,0,4,70,74,21,74
2041,WeBee,95,1801,0,4,91,95,34,95
2042,WebNMSIoT,241,5439,0,10,231,241,78,241
2043,weeve,52,1041,0,2,50,52,16,52
2044,WEISS,65,1322,0,5,60,65,29,65
2045,WellinTech,11,150,0,0,11,11,3,11
2046,WeMakeIoT,138,3003,0,5,133,138,30,138
2047,WEMS,21,576,0,3,18,21,12,21
2048,Werma,129,2637,0,8,121,129,42,129
2049,WestekTechnology,35,838,0,4,31,35,19,35
2050,WhaleDI,38,777,0,2,36,38,15,38
2051,WhereScape,225,6239,0,41,184,225,128,225
2052,WhiteTailAutomation,18,216,0,0,18,18,6,18
2053,WhitewallEnergy,56,895,0,0,56,56,15,56
2054,WhizNets,41,697,0,2,39,41,11,41
2055,WIBUSYSTEMS,149,2764,0,9,140,149,47,149
2056,WiGL,31,574,0,0,31,31,10,31
2057,WildcatDiscoveryTechnologies,21,439,0,1,20,21,8,21
2058,Wiliot,87,2331,0,6,81,87,42,87
2059,WindRiver,102,2449,0,8,94,102,29,102
2060,Wing,93,1654,0,2,91,93,18,93
2061,Wingtra,175,3905,1,13,161,175,61,174
2062,WinmateCommunicationInc,55,1118,0,3,52,55,22,55
2063,WinnerMicro,169,4342,0,16,153,169,67,169
2064,WinSystems,79,1867,0,10,69,79,43,79
2065,WinWire,40,658,0,2,38,40,11,40
2066,Wipelot,59,1153,1,7,51,59,26,59
2067,Wipro,153,3341,0,6,147,153,48,153
2068,WirelessGlueNetworks,40,786,0,5,35,40,23,40
2069,WirelessSensors,15,333,0,0,15,15,6,15
2070,WirelessTag,56,1350,0,2,54,56,22,56
2071,Wirepas,30,534,0,2,28,30,12,30
2072,WISEAI,39,801,0,0,39,39,10,39
2073,WISERSystems,15,172,0,1,14,15,6,15
2074,WiseSystems,67,1360,0,5,62,67,27,67
2075,WistronCorporation,8,115,0,0,8,8,4,8
2076,Witekio,58,856,0,2,56,58,24,58
2077,Witium,12,236,0,0,12,12,2,12
2078,Wiwynn,54,1025,0,2,52,54,13,54
2079,WondersInformation,164,3040,0,15,149,164,59,164
2080,WORKERBASE,95,1727,0,7,88,95,34,95
2081,WorkWiseSoftware,39,723,0,5,34,39,17,39
2082,WorldAware,151,3996,0,22,129,151,78,151
2083,XARIONLaserAcoustics,18,285,0,1,17,18,6,18
2084,Xavor,50,1114,0,3,47,50,29,50
2085,Xenius,31,612,0,2,29,31,18,31
2086,Xenoma,72,1407,0,5,67,72,20,72
2087,Xerafy,17,327,0,1,16,17,9,17
2088,Xformics,57,1347,0,3,54,57,35,57
2089,XiamenAlotcerCommunicationTechnology,23,391,0,0,23,23,5,23
2090,XiamenAlotcerCommunicationTechnologyCoLtd,23,391,0,0,23,23,5,23
2091,XiamenFourFaithCommunicationTechnology,5,141,0,1,4,5,3,5
2092,XiamenFourFaithSmartPowerTechnologyCoLtd,10,164,0,0,10,10,1,10
2093,XLOONG,29,456,0,0,29,29,11,29
2094,XOEyeTechnologies,84,1834,0,5,79,84,29,84
2095,Xompass,138,3189,0,10,128,138,50,138
2096,XpedLimited,27,461,0,0,27,27,6,27
2097,Xylem,67,1686,0,13,54,67,38,67
2098,XYZReality,93,1777,0,4,89,93,28,93
2099,Yageo,28,725,1,2,25,28,13,28
2100,Yale,21,414,0,3,18,21,11,21
2101,YamahaMotor,161,3640,0,15,146,161,70,161
2102,YandexDataFactory,100,2298,0,13,87,100,42,100
2103,YaskawaElectricCorporation,34,689,0,1,33,34,11,34
2104,Yeefung,9,109,0,0,9,9,2,9
2105,Yellowfin,43,1031,0,3,40,43,18,43
2106,Yitu,90,1609,0,6,84,90,34,90
2107,Yodiwo,130,3056,0,8,122,130,50,130
2108,YonyouCloudYonyou,120,2972,0,11,109,120,53,120
2109,YonyouNetwork,120,2972,0,11,109,120,53,120
2110,YoupuCommunications,55,1239,0,5,50,55,24,55
2111,YourTeaminIndia,31,520,0,0,31,31,7,31
2112,Youtomatic,255,5362,0,20,235,255,76,255
2113,Yuemes,17,291,0,0,17,17,6,17
2114,Z3TechnologyLLC,37,543,0,0,37,37,8,37
2115,ZealousSystem,129,2535,0,3,126,129,43,129
2116,ZebraTechnologies,93,2044,0,18,75,93,46,93
2117,ZeidmanTechnologiesOutofBusiness,15,276,0,6,9,15,11,15
2118,Zenlayer,98,2227,0,6,92,98,38,98
2119,Zenner,8,56,0,1,7,8,3,8
2120,ZennerConnect,107,2017,0,6,101,107,29,107
2121,ZensarTechnologies,145,3167,0,8,137,145,63,145
2122,Zensor,82,1757,0,3,79,82,25,82
2123,ZeroKey,43,738,0,2,41,43,14,43
2124,ZeroneConsulting,47,867,0,0,47,47,15,47
2125,ZeroneTechnologies,16,332,0,2,14,16,6,16
2126,Zest4,25,550,0,1,24,25,8,25
2127,ZettaSystemsLimited,67,1269,0,4,63,67,27,67
2128,ZFFriedrichshafenAG,105,2613,0,8,97,105,46,105
2129,ZfortGroup,41,610,0,2,39,41,8,41
2130,Zhizaoyun,20,247,0,0,20,20,8,20
2131,ZINTechnologies,46,765,0,0,46,46,12,46
2132,Zscaler,119,2584,0,8,111,119,44,119
2133,ZTE,276,5654,0,19,257,276,95,276
